235 158 174 185 239 252 74 183 244 160 16 204 107 112 79 212 132 3 5 255 94 95 31 194 223 44 187 199 227 24 169 78 228 212 39 241 252 59 189 178 181 112 145 175 165
85 119 36 224 90 31 205 211 94 95 206 207 127 13 164 94 149 230 182 61 181 249 245 247 221 213 107 207 231 42 51 98 35 148 123 44 29 191 77 27 192 33 147 88 39
154 82 232 54 114 174 194 146 94 153 17 25 160 20 213 92 181 81 217 103 87 109 94 131 207 165 182 100 186 25 94 245 130 190 233 62 81 44 82 66 125 195 27 213 184
107 180 222 207 94 29 164 53 236 47 36 181 121 171 203 87 161 163 50 99 100 113 179 186 2 14 173 8 36 95 140 97 171 192 140 209 9 243 3 10 75 61 67 6 204
128 229 68 19 61 130 90 113 111 154 12 203 208 58 109 22 24 195 34 50 174 44 127 154 20 4 204 61 195 166 120 146 163 131 95 0 158 218 79 161 255 146 136 16 83
78 154 131 215 252 220 14 73 71 124 168 108 155 151 247 255 104 240 222 96 246 178 7 49 50 106 179 172 148 35 226 105 0 193 113 235 52 34 150 186 62 124 190 52 98
130 92 224 162 124 156 23 224 131 190 68 61 53 5 234 116 221 154 163 220 190 3 140 251 120 104 32 62 154 147 19 144 169 149 12 46 123 196 142 15 176 134 158 0 189
255 43 8 106 175 166 39 217 91 9 197 206 140 75 104 70 137 149 18 40 57 102 98 233 161 194 154 124 146 123 148 164 117 76 189 176 211 123 207 215 80 74 198 227 91
93 175 185 136 149 129 149 224 19 136 219 204 149 9 252 29 132 169 119 7 86 120 90 32 56 80 154 76 148 121 44 86 140 230 84 110 173 194 172 229 221 221 56 32 208
247 68 31 192 53 90 232 22 117 72 244 248 171 186 37 62 216 200 67 57 18 59 143 224 217 153 162 166 187 79 72 53 19 174 67 45 159 19 32 22 126 142 116 253 8
158 53 99 93 226 145 87 216 22 155 220 57 236 205 40 88 118 44 144 174 45 190 9 128 106 161 27 182 84 105 152 150 151 54 23 148 234 35 86 27 249 193 26 46 47
41 48 94 115 7 209 91 170 184 15 239 181 133 105 80 181 45 90 12 52 236 121 87 112 183 197 146 193 34 89 163 222 55 55 162 249 23 126 18 243 182 4 215 215 252
37 241 228 31 110 235 45 22 62 227 238 86 82 85 238 23 77 65 206 161 54 170 50 54 144 215 4 94 69 208 47 106 35 171 23 151 132 50 192 242 116 135 45 171 60
208 3 173 243 110 162 244 203 225 60 233 95 215 72 203 54 28 55 18 55 219 187 118 43 62 43 75 89 254 141 181 206 75 193 66 186 13 85 106 184 105 192 74 105 86
55 151 227 203 67 86 227 136 48 99 125 178 159 22 38 250 206 110 18 69 233 106 104 243 84 128 230 242 201 230 9 229 88 163 73 60 94 7 200 189 23 97 215 234 34
133 67 90 38 229 194 185 6 19 8 186 24 178 154 8 65 58 240 27 17 8 183 107 98 185 94 92 145 242 45 214 157 141 188 42 130 119 215 148 249 128 113 62 183 222
171 187 220 210 46 254 95 79 115 232 3 65 162 102 167 45 244 0 110 101 193 82 182 229 146 188 142 2 99 6 119 72 252 83 194 149 103 144 24 169 255 138 91 156 85
16 178 85 74 174 163 158 72 207 220 101 3 95 23 144 155 116 69 152 225 173 64 22 67 249 22 158 35 161 136 3 24 127 99 227 51 35 166 171 167 181 56 200 65 80
92 47 175 217 138 250 157 114 56 214 132 197 151 73 202 116 134 133 230 227 169 175 197 108 169 174 27 154 98 203 133 41 115 12 85 122 78 134 69 90 204 234 193 224 83
75 194 246 207 209 10 35 137 63 111 73 83 183 121 177 223 39 85 220 139 171 202 103 114 125 153 122 23 117 162 41 192 218 244 80 65 40 238 19 12 167 197 51 233 251
117 159 232 142 100 33 225 140 3 103 20 80 15 131 6 139 186 80 99 148 40 239 237 166 69 54 95 75 85 86 162 132 254 118 30 118 90 60 17 166 0 46 228 167 197
239 204 128 213 7 55 1 111 249 222 61 74 155 130 148 133 225 46 164 31 155 206 65 242 6 102 157 24 213 157 252 224 129 176 162 192 96 81 13 57 206 170 173 152 140
158 125 133 115 37 159 12 162 118 173 75 7 52 186 142 249 107 186 212 173 250 156 96 99 74 142 75 83 163 34 107 144 34 224 230 101 7 40 166 190 25 37 128 193 149
125 1 76 86 241 97 190 235 142 5 151 49 171 224 171 59 38 59 144 94 29 18 191 3 128 246 161 35 171 104 198 41 102 117 54 174 2 39 21 195 134 146 130 38 48
53 202 211 87 24 175 51 141 64 22 183 221 229 150 243 165 197 150 179 101 81 158 212 41 96 231 231 37 122 179 190 158 114 117 62 99 57 11 19 170 165 243 223 237 184
199 131 184 1 178 237 135 227 232 30 14 250 73 87 31 11 164 178 36 7 46 162 8 147 252 86 214 149 166 175 134 203 155 0 137 95 119 118 131 35 194 9 50 17 158
67 111 202 40 206 28 229 20 159 165 177 204 35 84 211 217 115 85 202 80 63 116 92 72 182 249 50 247 86 237 232 154 52 0 41 55 121 172 237 115 108 143 32 103 178
25 152 184 53 46 237 198 52 134 65 243 104 215 40 107 123 170 73 244 87 209 238 182 38 44 78 201 110 118 80 85 216 104 102 235 49 209 192 184 37 244 157 216 81 148
7 34 205 211 189 34 115 232 152 184 185 63 58 144 43 11 189 140 22 221 2 30 219 95 34 192 163 26 14 122 102 13 67 29 8 117 246 82 214 210 237 225 190 219 4
252 155 149 115 26 24 118 156 28 70 146 85 108 43 106 36 59 64 120 213 36 10 41 144 85 96 19 178 145 139 189 231 127 4 119 215 8 124 229 171 103 210 21 154 46
34 83 118 121 46 255 119 94 72 241 114 247 59 237 107 83 156 52 81 55 85 112 226 16 98 114 234 93 9 64 83 7 169 241 167 77 15 38 227 182 170 121 225 51 191
127 30 58 202 177 246 200 48 203 13 204 62 205 178 93 231 225 120 179 141 226 240 233 116 154 3 136 230 69 134 162 6 100 235 1 164 17 74 150 216 216 102 236 116 24
220 9 6 237 241 163 156 10 123 187 22 97 38 205 145 235 152 210 243 158 235 192 34 140 232 197 207 56 58 127 96 127 249 123 127 78 39 80 66 195 180 200 49 94 118
30 157 115 106 34 196 252 234 143 85 134 83 19 80 34 139 228 143 87 1 71 95 26 12 140 195 26 245 202 214 95 19 177 171 207 63 83 165 58 123 165 185 120 24 59
183 255 208 108 191 254 211 110 213 92 102 155 190 171 37 209 98 3 178 208 107 202 170 80 56 58 25 178 143 95 253 228 119 127 67 18 18 75 208 145 64 237 236 175 149
32 77 232 26 153 21 185 74 149 116 99 127 121 96 83 102 98 52 153 154 40 147 31 40 59 66 229 242 55 19 203 167 46 94 147 74 34 32 252 174 99 137 60 1 241
194 47 74 84 48 116 110 34 217 103 40 208 170 11 167 244 96 31 76 170 135 118 99 134 123 206 228 48 170 199 212 112 231 148 222 198 76 162 167 242 35 57 33 220 10
216 93 201 253 188 194 156 58 139 207 252 242 38 233 204 122 176 141 8 46 150 57 151 142 168 90 43 243 168 222 69 19 224 141 193 59 171 79 35 161 222 133 174 121 242
181 174 148 189 100 51 8 53 242 213 255 128 162 90 75 181 134 113 64 39 127 197 41 203 44 186 61 19 87 230 42 63 130 4 21 10 139 121 188 125 11 137 250 127 164
99 148 210 21 190 184 209 96 204 155 182 130 208 94 156 231 188 147 184 83 240 166 14 12 246 62 106 230 125 201 186 124 180 146 79 0 27 32 67 92 83 12 66 126 163
135 78 53 211 136 90 73 84 151 23 194 116 76 11 121 8 72 224 239 45 17 24 9 42 251 63 164 33 63 43 100 129 29 169 15 2 55 164 1 58 234 253 212 16 120
99 119 228 220 251 195 158 122 150 86 25 49 22 73 232 239 29 83 117 206 235 182 235 192 175 33 36 159 122 185 51 53 239 159 135 161 145 251 110 66 90 168 145 182 182
145 110 184 111 24 153 224 35 39 236 87 185 33 155 224 160 165 243 39 255 127 124 119 3 106 246 206 76 88 205 63 146 248 221 127 194 54 225 188 163 67 135 126 183 140
128 18 91 126 114 36 61 15 139 87 70 144 95 9 77 70 161 226 59 38 203 208 89 142 148 239 38 77 86 81 241 225 213 43 153 175 29 154 31 178 143 33 182 146 3
2 78 155 219 135 107 242 239 57 103 46 105 245 230 246 131 170 242 196 167 63 228 73 54 201 174 89 8 209 14 232 191 161 51 70 164 63 52 232 209 173 183 160 8 171
19 167 170 244 34 47 220 91 95 231 37 101 114 53 58 102 42 174 208 111 115 114 239 162 56 14 32 84 126 224 53 173 202 214 160 94 88 63 222 250 74 95 241 243 23
80 155 114 31 201 108 12 108 41 236 80 236 246 225 118 61 150 96 80 163 31 204 36 216 11 134 136 57 62 110 153 142 92 206 145 111 245 151 236 140 177 70 83 50 99
247 25 197 236 60 91 121 29 229 233 83 0 174 154 126 29 35 161 226 213 81 28 25 18 240 191 28 14 207 13 104 80 189 232 142 32 24 57 255 53 201 53 0 16 63
222 1 204 182 185 196 188 87 116 226 190 1 156 146 178 239 176 3 30 140 247 114 121 80 201 194 59 224 137 62 231 127 74 57 114 215 66 209 151 77 60 30 232 62 136
101 149 234 182 98 146 160 239 89 37 74 11 181 185 160 33 116 161 72 52 147 117 181 71 112 127 155 219 36 8 154 31 66 90 128 5 99 245 7 70 249 141 112 102 138
29 200 85 15 148 184 86 162 85 143 163 148 148 153 52 124 106 249 43 186 45 232 129 193 111 106 74 108 127 30 33 230 99 241 158 112 125 166 174 219 145 177 13 129 203
176 154 228 193 86 213 230 139 254 3 168 136 179 106 190 36 246 209 239 89 142 158 40 40 210 161 48 164 33 31 156 135 90 24 172 106 134 234 237 149 242 39 87 221 71
17 22 167 130 56 64 78 41 150 116 2 186 34 38 191 18 166 145 90 221 106 156 37 189 61 22 59 124 49 30 46 120 124 48 176 117 125 38 90 88 42 186 251 87 122
133 177 178 107 39 21 106 178 169 235 206 159 86 104 119 244 14 79 194 219 195 211 254 0 143 248 179 95 246 211 44 167 58 9 191 203 3 163 42 18 84 190 59 228 246
93 157 235 177 60 132 151 250 15 3 103 176 214 66 131 80 80 190 246 1 119 150 240 79 162 217 253 69 4 86 66 242 197 167 222 43 133 151 198 215 91 31 77 239 160
138 235 68 182 53 24 155 157 117 117 120 235 186 35 23 160 154 19 214 101 178 130 243 93 228 63 137 8 69 33 82 33 95 108 232 67 56 12 97 144 23 176 141 156 175
143 202 245 63 128 220 207 219 205 204 206 116 50 224 99 17 241 130 90 76 151 233 118 25 152 119 57 170 94 129 210 152 136 177 242 2 186 6 29 131 22 132 61 159 116
158 64 63 206 85 2 158 52 212 199 253 100 184 50 223 99 155 241 20 234 246 62 63 7 237 150 152 231 137 79 126 186 237 251 122 38 142 33 81 255 61 61 203 139 141
228 77 175 136 33 181 97 222 186 199 64 239 101 75 39 201 251 151 91 107 170 240 195 245 180 97 11 158 42 255 211 253 128 43 223 130 73 176 191 47 211 179 27 148 84
179 149 178 37 88 217 179 104 41 73 235 193 170 229 116 44 225 133 85 62 198 21 131 32 211 113 21 240 254 232 178 141 156 203 219 69 154 9 246 71 213 2 146 77 149
131 112 210 250 111 200 196 124 120 163 55 163 189 180 12 24 3 135 179 152 70 30 173 25 255 49 108 243 167 212 90 61 78 91 20 104 201 160 243 12 250 168 235 128 56
122 125 120 156 149 36 98 135 183 23 196 114 242 139 194 41 67 34 248 43 17 48 75 164 94 165 135 199 120 84 22 129 74 214 59 57 108 144 34 195 50 152 238 77 119
35 147 189 167 24 187 142 46 140 117 237 1 214 0 136 231 143 209 130 34 154 170 161 107 244 110 174 248 232 241 35 156 88 161 11 252 44 111 155 201 238 89 126 91 101
71 150 27 89 157 54 138 18 7 81 54 0 75 45 127 2 139 240 207 126 31 153 95 115 143 100 229 170 210 146 76 4 138 154 232 182 87 75 128 25 220 104 15 116 178
253 148 215 0 145 205 86 250 225 214 248 90 12 246 32 238 163 0 179 140 27 242 244 234 134 232 8 97 7 121 116 223 252 238 217 119 110 146 229 173 210 227 100 167 82
148 119 5 28 77 20 227 195 137 238 59 158 205 29 198 230 197 19 175 248 175 162 56 46 135 74 247 196 207 140 66 173 84 23 180 36 135 165 17 253 94 255 176 185 76
166 0 229 162 103 24 223 217 134 174 140 9 197 128 4 160 203 245 208 241 62 209 124 130 229 109 177 158 85 167 12 74 18 75 68 33 250 124 216 29 83 118 187 205 133
153 117 247 122 67 218 252 238 134 137 90 122 244 156 121 158 165 163 192 188 99 160 162 97 204 84 76 244 54 213 51 50 55 157 168 243 193 245 2 201 113 80 25 206 237
166 88 87 244 189 137 63 181 207 5 116 173 32 99 3 144 209 122 43 3 8 176 175 24 74 45 17 225 236 161 194 75 146 156 108 195 101 31 84 111 175 176 110 110 209
172 13 202 204 200 32 12 106 84 165 48 17 100 28 168 4 88 201 120 75 238 104 224 138 195 115 25 233 173 30 234 212 210 196 30 150 134 226 184 186 98 98 65 134 87
4 221 120 138 248 36 179 200 55 225 120 126 80 83 136 36 229 222 2 173 155 104 79 9 158 32 165 108 73 142 3 121 192 68 225 122 231 66 27 197 234 118 181 182 78
196 243 43 150 115 168 215 233 198 96 126 231 109 187 210 119 115 163 141 60 240 240 194 234 17 136 84 188 192 32 42 205 197 161 96 92 114 31 9 111 210 66 145 81 235
25 141 58 145 177 26 180 196 145 103 76 227 159 204 228 90 71 99 192 28 149 237 22 185 154 99 85 161 8 59 241 54 86 255 175 80 123 188 42 192 205 124 192 56 88
150 104 120 133 84 150 70 39 73 139 145 172 235 33 46 122 163 178 187 202 123 227 244 0 193 79 7 236 233 101 66 179 240 23 165 193 45 27 232 174 44 231 65 6 202
24 3 136 188 208 182 195 164 97 118 74 155 4 66 231 221 12 37 24 72 80 204 88 154 145 36 6 137 178 16 15 222 133 98 35 31 13 147 131 235 150 83 95 103 125
204 69 189 221 95 109 115 181 6 86 189 125 212 196 0 253 192 154 59 11 72 171 202 232 153 31 136 105 245 45 132 121 200 51 197 41 54 142 207 70 13 99 196 89 186
16 244 187 253 116 70 17 108 233 204 144 29 14 170 197 126 166 5 176 124 31 163 196 224 108 222 78 173 174 40 1 85 173 95 11 235 95 145 54 247 92 84 147 149 118
79 131 142 142 101 121 139 176 72 80 176 233 254 133 79 188 253 134 226 80 36 143 54 73 243 108 124 15 56 102 83 67 83 206 183 200 37 12 48 240 6 16 213 181 8
164 17 154 91 103 128 143 162 95 235 165 26 104 162 89 88 127 251 154 178 179 191 75 9 80 111 59 5 141 164 127 40 123 224 26 224 92 231 61 156 74 12 185 205 225
55 224 8 135 31 190 71 90 198 179 56 182 108 206 114 120 2 224 63 35 250 144 241 111 86 16 125 119 140 187 145 212 200 105 229 102 126 176 245 214 177 48 141 139 35
9 46 111 76 186 25 156 213 85 122 234 112 127 147 157 161 111 15 72 136 221 82 66 109 172 185 0 93 48 184 170 173 82 142 150 192 81 253 228 131 249 152 182 19 225
229 165 8 125 169 137 75 131 165 17 216 122 6 26 213 166 238 79 144 169 41 177 217 112 224 94 245 110 61 235 5 23 103 117 218 197 180 181 42 21 236 224 243 172 119
192 7 207 185 207 227 144 67 120 62 69 76 217 185 81 154 202 227 165 151 199 240 139 56 228 237 134 211 129 3 228 203 164 171 251 130 123 68 149 138 211 208 183 19 103
212 76 124 157 161 151 71 81 244 112 6 107 84 92 222 34 194 7 28 137 140 245 41 157 92 239 122 56 67 101 146 183 100 144 248 169 48 89 50 118 71 168 12 199 140
195 66 3 102 112 52 224 60 35 18 77 79 9 92 77 79 143 88 96 254 56 250 19 69 217 238 134 135 15 251 12 8 244 86 87 150 83 41 226 94 142 167 240 162 103
220 181 117 187 110 32 131 1 19 223 106 65 249 215 222 228 29 222 240 206 175 21 169 81 207 114 141 42 70 81 117 66 213 76 65 230 246 242 250 207 172 73 197 160 163
206 154 222 174 55 189 152 152 249 87 195 41 91 106 37 137 105 70 158 224 184 238 217 209 165 119 46 50 166 203 181 186 233 170 206 237 179 8 27 226 208 57 92 131 85
131 238 107 165 54 30 88 182 92 113 139 80 186 12 243 238 126 53 222 127 18 91 203 82 55 57 54 197 29 233 24 58 143 12 206 5 228 211 171 166 55 33 191 248 83
150 249 93 42 138 86 40 40 251 18 23 60 135 240 233 151 184 168 213 15 141 45 161 243 70 223 195 45 222 196 89 254 116 192 49 170 155 65 239 15 233 45 233 147 133
237 137 163 177 27 10 54 120 106 143 5 253 135 230 143 231 100 173 146 49 182 107 197 140 190 185 251 137 39 71 124 17 36 19 228 135 42 171 255 127 91 157 22 43 132
69 170 61 109 238 229 161 162 101 59 45 219 187 34 28 51 120 171 193 42 218 131 182 22 224 132 3 92 188 251 55 154 249 238 86 123 242 192 194 240 56 250 98 126 85
92 48 55 93 120 180 80 32 13 223 216 89 71 33 39 87 201 233 213 135 150 102 249 8 35 145 187 6 34 236 78 143 248 159 221 105 146 211 209 66 48 207 32 166 165
167 203 167 152 87 173 2 67 167 135 46 177 126 201 239 9 4 66 237 249 58 233 15 53 78 124 65 215 214 50 249 220 63 124 200 160 90 55 84 178 244 250 23 229 191
13 93 121 56 64 207 11 224 151 109 199 196 126 145 5 50 211 20 105 235 197 209 142 37 64 124 188 0 148 100 58 159 47 248 82 100 180 144 132 148 192 101 47 1 26
86 128 230 134 6 229 116 87 19 127 126 144 48 22 6 141 214 106 69 118 58 182 9 209 35 197 19 108 229 253 152 234 146 236 216 127 16 32 222 209 162 171 124 222 226
35 251 16 139 131 181 149 158 250 68 216 6 142 248 140 110 181 160 152 104 32 135 252 244 220 229 135 54 104 171 255 68 179 36 43 145 11 249 171 100 255 105 205 148 45
85 119 122 182 14 179 82 75 215 155 125 17 49 35 44 36 224 42 106 222 44 247 40 5 54 236 159 36 79 122 240 8 131 27 136 124 48 39 23 138 60 154 50 20 200
86 208 43 139 181 113 218 92 220 186 253 43 61 8 228 8 179 170 60 100 172 102 43 75 49 104 24 133 105 84 24 218 139 112 33 248 69 29 191 130 76 148 190 197 15
176 58 125 86 236 241 178 70 122 112 108 241 245 97 184 165 228 204 62 102 73 65 186 235 128 204 47 106 74 179 75 26 79 44 30 210 50 22 250 144 178 215 152 130 101
192 19 150 134 212 133 102 137 239 70 219 168 104 213 225 182 99 120 104 234 203 93 242 206 61 21 24 233 154 129 147 192 173 6 180 177 170 251 8 111 59 170 8 11 55
74 101 23 171 162 181 136 52 250 105 158 19 57 216 175 236 149 71 241 104 177 45 88 6 137 161 169 34 155 132 16 17 244 165 19 180 181 94 15 30 185 243 12 164 96
252 69 130 113 160 149 71 9 91 90 171 216 211 114 141 59 18 165 200 93 247 186 91 172 29 166 17 242 34 175 149 162 145 195 132 41 250 221 70 238 91 205 84 74 80
245 142 6 254 122 180 184 155 218 164 174 57 70 101 148 185 162 104 2 172 177 138 154 212 166 175 174 217 157 49 172 249 75 94 209 78 104 118 107 173 12 86 186 125 149
83 136 212 116 40 26 159 1 20 42 59 152 112 207 193 112 172 112 137 134 39 24 186 24 214 155 79 212 38 22 243 146 84 13 96 53 245 171 21 129 149 98 223 14 122
245 182 61 76 38 172 89 243 159 10 223 14 128 236 123 223 41 243 83 23 198 176 160 246 88 175 50 7 50 114 75 105 54 67 239 179 201 75 4 84 72 253 91 142 190
41 64 106 161 2 3 134 98 170 200 204 107 249 63 145 227 208 64 32 111 127 107 56 220 19 143 49 190 105 222 11 248 253 170 28 240 180 178 49 80 137 144 46 122 252
193 226 119 10 17 152 56 122 98 83 34 202 42 24 211 3 13 27 219 5 135 167 132 103 175 161 2 29 24 161 70 207 92 16 94 92 186 32 25 39 11 91 51 184 77
228 226 131 77 250 58 246 181 157 25 252 176 170 112 66 30 166 71 241 26 103 167 35 72 22 62 171 56 5 229 92 33 46 2 130 23 11 88 34 130 196 63 12 120 161
247 14 120 242 159 14 61 12 149 63 200 101 201 104 114 194 163 147 102 170 42 96 87 194 161 232 56 99 142 226 77 65 204 131 91 185 170 228 133 219 109 21 255 133 207
12 147 18 47 250 176 151 114 242 37 102 61 166 115 82 78 152 164 237 77 112 230 232 119 32 58 167 88 0 106 113 62 112 164 118 230 177 27 242 187 89 58 196 64 212
157 185 86 116 220 246 114 156 129 247 172 107 9 114 34 74 184 151 236 209 146 62 132 2 200 116 215 197 166 33 76 141 18 67 60 217 99 198 6 238 8 62 219 240 166
221 226 93 141 76 220 49 32 92 104 209 66 237 139 106 198 181 92 97 42 154 99 184 114 38 167 48 165 215 38 100 104 202 213 119 127 216 136 23 100 35 119 171 138 51
18 64 6 76 106 3 188 76 192 94 222 116 168 222 174 42 104 39 205 0 222 97 127 253 10 139 95 83 155 70 176 78 176 71 137 247 189 158 99 247 31 202 240 240 43
90 217 42 229 29 16 225 160 171 204 172 227 70 119 207 109 128 217 4 132 118 186 177 159 108 62 110 39 60 122 7 254 88 182 76 141 108 67 61 77 110 30 96 152 54
160 76 255 66 65 105 160 83 75 95 211 3 100 144 210 192 65 110 246 28 153 192 134 227 235 108 139 162 243 36 55 6 241 167 69 162 90 26 188 216 108 114 90 103 168
79 139 28 183 251 101 227 92 117 63 216 181 130 189 6 32 241 33 136 211 162 160 35 92 9 36 44 139 18 49 207 96 129 136 187 194 247 141 192 132 79 28 166 15 173
92 233 78 185 24 29 99 126 49 70 108 98 45 151 171 2 60 182 6 30 80 247 144 136 69 131 170 7 183 39 4 142 125 38 230 74 135 191 109 196 92 115 190 188 133
92 126 143 105 70 65 198 111 25 250 125 33 206 5 6 20 153 218 0 229 236 55 214 12 13 13 212 53 243 28 32 85 211 45 141 111 127 189 159 195 16 162 85 57 166
98 76 171 144 225 107 253 69 188 58 133 231 7 88 199 190 0 172 33 182 215 54 115 188 229 202 225 11 5 2 108 135 66 107 209 167 3 197 32 149 86 26 125 17 32
205 50 181 242 211 75 166 168 80 76 130 0 2 7 127 230 247 7 164 255 104 217 196 190 138 169 21 15 89 124 181 83 215 52 233 79 111 139 214 208 77 70 250 173 207
89 225 144 215 128 2 43 83 176 7 28 120 40 115 131 103 231 30 59 58 186 125 159 109 0 185 140 53 99 13 137 70 87 176 225 162 175 113 252 44 224 171 238 85 182
81 182 248 83 235 135 16 113 233 7 31 57 38 117 251 118 175 136 5 59 59 11 44 189 133 232 0 84 66 42 9 64 182 226 226 213 1 18 83 70 167 192 243 109 45
125 251 217 251 243 49 99 148 94 59 171 182 162 248 116 197 24 221 102 249 1 117 141 152 137 216 112 76 64 136 130 230 74 153 239 21 34 76 240 112 116 49 76 110 208
45 225 48 47 126 36 167 119 248 149 20 96 250 233 79 7 44 117 66 64 230 180 169 35 46 165 99 81 72 251 180 20 142 124 14 9 42 38 42 75 154 228 115 161 13
96 198 3 87 10 229 36 153 31 250 80 131 112 150 40 14 204 80 180 14 143 137 20 169 94 73 45 37 195 124 97 108 95 209 254 5 8 127 196 14 253 98 127 152 62
223 85 138 95 173 147 82 121 126 34 43 216 246 76 194 200 15 253 27 228 36 83 10 217 225 61 192 106 165 171 67 100 174 55 119 148 253 119 92 206 196 187 224 116 108
84 53 13 26 35 75 127 67 30 136 9 176 25 171 11 161 119 15 156 140 1 105 203 45 136 242 145 104 242 230 195 60 3 180 220 62 126 177 202 218 213 82 135 241 198
118 230 234 174 187 227 97 79 133 95 83 196 92 213 181 154 193 147 72 22 102 78 194 99 86 30 160 103 46 220 27 103 50 49 63 15 251 97 11 140 26 137 204 124 223
221 94 98 46 52 242 198 15 116 167 92 200 33 23 134 80 221 210 122 161 131 24 254 43 171 223 220 180 17 74 25 4 129 143 189 84 72 9 38 85 51 49 186 79 132
225 99 9 93 209 144 172 231 234 197 150 221 226 26 224 243 203 114 194 137 101 165 167 172 147 111 253 29 216 141 235 253 249 111 248 139 181 67 205 117 226 40 20 182 102
157 249 243 203 162 14 42 221 27 202 37 190 232 233 146 224 12 241 250 18 204 241 32 27 220 195 161 175 60 2 27 114 229 84 245 119 0 251 124 197 204 8 42 149 191
80 160 239 152 8 180 206 69 142 17 205 29 1 146 227 209 67 173 251 162 244 140 116 213 176 190 202 191 126 136 100 176 144 23 84 115 110 113 198 166 128 63 45 236 34
83 236 100 243 122 154 188 239 251 245 52 69 64 14 75 190 104 207 89 155 223 229 178 204 71 51 37 154 115 175 32 142 80 52 49 19 62 102 47 8 141 48 251 178 179
178 98 124 146 164 167 112 57 68 131 149 195 124 96 240 145 112 85 76 232 27 120 183 14 13 68 155 27 254 138 130 100 167 202 125 126 28 230 247 201 157 7 155 145 177
248 168 71 53 229 249 202 153 47 39 115 58 80 95 213 17 81 189 187 59 113 226 69 142 35 166 67 238 15 142 121 42 202 1 154 44 236 33 235 176 87 29 54 84 46
135 80 91 228 131 163 115 251 190 117 107 50 9 50 148 113 230 107 120 66 113 59 65 252 228 81 37 149 235 10 5 252 230 59 208 201 150 77 47 4 223 177 245 99 199
37 33 54 195 160 38 48 180 151 189 64 186 67 84 218 219 198 128 5 116 38 205 149 61 47 23 238 92 46 211 236 176 1 253 98 6 101 66 114 213 3 13 6 198 112
92 141 66 203 147 85 55 236 109 17 146 123 200 252 196 28 89 56 155 144 109 231 240 7 213 192 100 83 129 235 181 24 149 21 184 83 145 150 172 11 73 203 39 185 91
218 242 59 202 37 240 130 168 29 155 211 153 242 142 30 8 155 232 165 160 2 78 140 32 120 226 119 176 25 126 251 13 83 164 99 14 59 183 202 133 66 185 18 131 94
168 92 100 55 116 113 107 148 5 141 76 66 161 74 73 91 2 26 0 253 97 247 69 97 70 147 89 17 169 155 74 241 75 243 218 195 79 164 71 96 179 83 39 72 69
249 87 79 64 181 26 102 90 9 16 73 119 152 106 145 213 123 195 71 66 24 189 125 64 229 51 206 170 255 190 143 183 145 233 131 127 117 115 249 209 2 119 199 112 179
122 141 248 73 80 169 10 228 112 208 71 117 139 196 12 109 85 174 147 75 212 111 161 23 115 135 113 22 74 74 126 202 154 25 114 201 71 51 206 23 69 94 31 199 230
203 224 26 181 254 120 246 204 156 191 190 9 190 248 53 82 19 13 153 43 132 114 167 105 33 254 118 45 42 64 234 190 113 209 99 174 99 250 120 205 155 213 74 21 206
94 64 78 243 213 85 48 241 82 33 237 174 89 210 73 12 119 59 43 102 5 55 133 94 240 213 100 162 30 35 57 122 50 48 132 147 253 223 103 58 97 62 242 206 96
50 8 224 244 125 170 24 9 79 197 136 237 161 143 228 131 215 153 181 16 64 168 240 190 21 168 170 38 146 247 102 107 93 86 58 191 13 185 0 159 44 122 11 56 0
56 72 55 234 171 199 149 158 198 86 98 114 209 246 247 7 124 210 240 69 213 176 227 230 197 80 115 68 129 189 171 136 144 196 244 234 243 219 174 176 182 253 133 23 56
222 203 36 86 242 197 210 204 250 124 161 157 175 55 202 241 212 14 217 217 166 121 115 99 231 170 154 99 99 14 190 123 67 57 65 222 15 96 109 170 224 19 254 177 198
195 105 89 34 164 179 40 242 159 164 247 134 235 59 135 137 98 93 103 239 189 226 224 8 130 225 8 221 199 129 42 130 188 78 190 227 211 151 2 66 48 11 102 174 13
238 220 45 116 200 13 184 18 50 123 242 7 218 233 32 113 104 182 246 55 148 50 114 53 163 113 63 15 102 43 21 104 64 83 31 53 254 243 133 176 24 81 175 72 172
80 21 184 82 21 14 134 142 55 206 227 155 84 178 251 137 199 51 44 199 14 160 206 150 139 122 220 53 235 246 152 201 38 155 53 102 182 52 176 198 28 4 192 9 164
100 182 137 165 143 33 45 57 230 250 17 210 82 234 15 39 36 39 66 39 206 104 1 191 37 88 176 131 178 28 87 183 175 76 6 202 146 73 76 122 56 45 64 120 104
76 118 36 254 238 253 160 140 109 147 94 57 121 141 165 126 172 7 2 195 77 133 217 101 62 219 61 232 92 11 110 225 35 167 132 230 60 129 65 44 108 192 104 7 158
79 182 156 103 248 0 137 111 59 251 187 206 129 22 197 80 104 108 80 101 28 226 21 106 3 253 80 224 159 246 158 154 205 216 84 70 251 228 166 211 241 71 96 99 24
152 100 166 135 159 76 39 210 91 119 88 132 224 91 242 199 171 38 125 237 19 152 69 45 206 8 118 178 160 38 0 22 252 189 249 48 26 113 137 64 68 89 34 213 123
236 139 181 197 224 130 208 169 10 237 102 124 127 96 190 14 64 114 5 161 159 139 207 182 82 198 30 242 149 122 142 221 166 179 187 144 75 120 129 58 28 209 20 45 213
26 66 44 190 72 156 179 78 48 82 73 57 216 149 165 66 242 150 231 5 102 87 28 113 147 190 81 35 75 129 34 109 121 137 93 100 205 98 14 146 232 123 74 32 147
61 73 88 193 49 9 67 118 143 89 51 122 206 159 141 191 26 105 180 60 23 112 93 230 152 123 222 155 126 220 10 197 92 68 80 178 123 46 127 245 56 242 90 162 191
204 83 17 118 164 34 22 130 187 139 162 3 150 244 222 49 76 220 193 247 229 51 227 168 76 71 2 177 73 122 246 85 144 207 93 72 225 253 243 142 19 78 119 189 45
216 119 8 97 173 212 85 155 78 252 236 118 124 0 201 197 172 224 228 13 18 89 110 54 155 78 192 110 152 175 41 75 241 201 0 236 179 98 32 123 53 32 167 135 113
157 88 30 232 38 67 249 18 213 14 20 207 253 230 22 21 35 166 1 198 52 197 255 170 131 193 188 91 47 32 251 115 187 243 50 97 74 16 55 8 145 45 61 175 60
218 16 167 10 171 145 48 112 55 212 147 8 217 231 178 58 182 56 215 104 34 41 226 186 107 48 65 236 30 106 25 107 143 51 175 35 111 200 27 246 229 144 4 229 123
166 85 208 116 30 215 12 255 117 183 177 57 164 199 95 104 124 43 66 137 203 233 236 187 81 42 115 7 131 7 117 210 153 188 161 242 203 93 207 39 224 158 176 224 143
218 31 225 207 115 29 145 146 138 229 140 49 21 77 113 130 71 89 119 158 31 122 100 55 222 42 117 173 213 78 182 193 178 252 115 51 245 61 49 228 19 130 164 86 123
241 200 53 27 39 118 238 203 95 148 92 197 67 75 50 201 56 130 255 42 83 96 17 246 163 42 42 34 180 141 101 196 104 184 153 112 95 100 42 191 46 124 32 153 153
101 165 87 67 203 129 221 42 85 115 155 204 240 42 163 219 226 144 114 237 197 83 17 11 172 19 37 85 46 196 42 10 107 94 239 45 163 41 1 229 18 232 226 21 137
84 21 160 23 253 79 203 32 70 227 33 146 240 174 41 124 63 100 115 122 159 73 195 145 127 49 1 104 71 206 234 111 117 71 120 80 34 233 132 173 131 137 66 157 111
118 55 8 164 196 46 142 146 205 69 11 50 58 240 91 30 58 5 134 170 11 248 174 250 243 61 13 20 34 39 118 178 207 196 255 167 41 90 44 159 119 119 14 16 149
183 252 78 38 108 98 97 65 156 54 9 86 4 137 194 130 92 81 38 41 151 135 197 255 122 234 74 234 167 134 112 69 46 111 28 103 119 40 86 241 159 151 141 219 216
61 173 212 247 45 91 189 47 72 18 57 73 38 86 245 195 208 41 119 63 131 134 132 133 152 37 16 55 89 105 115 231 239 115 120 210 155 105 90 242 194 22 193 109 205
156 61 207 172 227 59 92 202 213 66 157 92 51 153 102 138 9 0 226 122 163 27 78 36 253 126 9 59 148 79 75 10 98 28 125 22 124 115 154 244 5 48 114 241 74
87 223 144 87 34 6 4 228 150 55 221 230 223 116 42 42 177 144 232 149 82 236 71 75 138 35 247 82 153 195 3 255 253 125 56 162 113 87 39 8 22 244 68 8 42
153 100 178 209 92 96 17 22 28 9 71 23 231 164 126 202 168 103 66 63 0 128 96 147 239 101 176 232 150 33 111 226 7 74 72 194 108 123 220 177 170 54 121 234 155
251 80 234 4 134 77 173 91 51 239 143 158 90 248 168 174 202 95 108 6 181 113 152 188 100 103 244 108 184 57 118 237 186 46 55 35 192 148 124 173 154 241 72 155 220
4 163 189 18 57 48 191 252 206 177 21 94 124 163 38 228 71 252 45 238 147 104 117 182 177 111 240 64 76 63 210 30 163 16 158 178 237 186 44 135 139 41 198 248 198
19 164 244 79 29 29 207 149 156 188 86 214 247 220 22 192 127 37 0 87 49 239 227 17 253 38 189 24 224 246 170 64 20 79 168 245 52 191 254 148 30 53 57 21 30
205 143 139 183 183 119 254 212 164 129 233 165 42 203 28 71 159 0 76 249 192 193 166 25 215 215 228 30 92 119 96 115 223 95 170 9 55 38 63 250 176 190 177 172 211
96 57 139 112 193 165 3 7 176 50 125 99 64 222 125 125 74 191 46 218 117 253 228 31 50 27 109 248 170 80 66 135 133 128 157 127 74 229 48 80 211 215 187 6 144
71 196 218 203 210 210 235 127 57 127 142 139 209 39 183 143 154 34 131 39 227 157 48 244 104 110 78 163 42 122 113 112 57 113 31 131 87 146 200 109 129 40 182 28 15
103 119 57 190 194 245 208 17 126 140 57 131 17 163 221 135 199 227 198 76 227 39 154 29 59 158 176 204 1 144 193 226 251 193 104 157 32 235 38 107 21 250 184 187 3
251 110 119 147 42 149 27 245 12 171 203 75 194 66 244 235 248 118 171 27 194 46 251 243 35 164 78 76 180 11 140 7 13 34 27 153 69 40 60 227 233 38 215 160 82
