86 145 151 204 64 187 106 233 10 205 224 8 196 74 151 3 15 6 160 115 76 196 185 254 176 94 242 240 92 196 167 234 158 102 240 107 12 107 150 8 87 81 100 211 104 153 234 57 170 211 13 23 122 26 34 255 236 111 44 39
65 124 70 225 181 61 124 124 122 5 208 202 228 23 227 41 184 191 8 44 16 17 48 84 192 184 155 38 137 105 162 87 253 89 91 133 87 97 122 219 137 147 94 87 190 224 168 222 181 200 25 14 231 83 99 147 70 65 23 135
104 233 129 227 209 59 212 130 172 139 186 251 79 160 228 250 180 128 121 111 212 65 205 81 34 74 210 109 115 75 74 57 179 116 176 18 245 133 221 152 35 166 18 97 252 246 221 126 108 104 81 196 11 167 75 70 209 40 79 197
148 232 115 68 197 62 132 118 242 245 189 130 91 113 35 49 67 3 252 111 17 114 185 16 108 239 216 244 78 4 70 72 189 46 87 145 82 88 120 46 85 203 116 244 77 148 34 36 26 194 220 63 86 132 169 96 220 118 251 175
131 56 209 176 158 44 242 137 226 25 15 89 127 207 52 128 223 165 15 210 137 16 118 152 24 148 99 46 111 14 186 145 42 145 152 31 187 102 21 128 203 48 255 82 236 170 240 11 100 41 216 219 142 67 119 171 8 22 167 213
177 122 248 49 176 252 240 80 195 215 213 213 62 178 218 152 35 167 241 144 90 211 52 103 91 47 6 112 243 95 50 205 74 173 46 25 170 72 161 92 155 13 211 175 77 130 122 92 54 244 183 220 202 53 240 70 47 88 1 225
216 22 103 45 19 38 75 96 79 108 104 31 206 132 51 130 183 88 199 20 216 85 197 77 142 206 51 38 44 120 252 134 52 198 219 144 151 185 239 199 227 172 37 134 8 85 29 143 160 220 95 155 20 58 72 20 190 210 87 224
145 61 210 189 107 171 227 104 98 190 128 231 179 52 44 27 141 106 143 11 116 253 26 235 9 38 190 1 21 22 89 181 248 158 173 254 150 102 241 186 223 255 88 106 216 42 3 101 84 154 221 4 68 95 240 138 128 209 149 31
210 4 66 223 163 50 45 117 116 14 164 253 117 206 144 173 223 217 105 129 0 66 225 1 231 54 119 135 137 154 224 104 110 240 103 38 133 235 161 228 108 185 190 213 218 201 80 14 134 24 82 115 98 93 78 95 166 239 8 177
21 95 14 28 162 35 128 58 39 68 24 166 250 200 131 107 233 94 220 89 78 163 236 112 144 184 123 175 252 149 204 87 103 101 35 164 24 142 110 74 236 12 171 44 90 152 96 66 91 155 230 53 44 25 205 237 150 173 154 210
235 92 243 9 126 149 148 99 127 0 48 172 230 178 168 156 112 113 167 209 79 178 208 151 158 97 169 243 29 79 29 193 221 235 45 128 107 240 237 197 24 149 15 34 126 206 58 186 122 128 146 134 121 170 228 30 156 17 11 175
151 104 248 31 241 176 153 62 238 190 130 92 52 44 121 207 35 60 22 60 78 109 130 41 48 169 113 96 125 157 46 94 78 98 156 202 79 200 213 20 187 3 27 190 117 57 62 255 189 163 9 240 236 10 23 168 19 213 77 201
159 92 99 55 119 27 184 10 63 59 200 198 39 5 230 6 11 255 24 86 47 136 248 89 86 31 238 158 40 232 125 230 87 21 71 233 249 103 123 39 55 50 100 173 208 149 215 38 35 114 56 36 42 134 53 76 24 125 184 206
217 201 19 150 17 90 117 21 51 42 121 209 124 242 187 223 204 68 139 187 233 222 235 136 110 128 64 70 218 216 34 63 113 79 191 213 120 79 63 144 248 28 50 206 112 29 11 0 33 127 43 193 252 49 196 107 186 169 25 4
30 196 26 80 137 35 12 19 14 212 108 213 218 115 235 91 46 192 79 183 183 215 165 81 220 70 203 17 168 112 133 199 102 89 88 97 109 61 81 52 161 152 143 42 198 14 166 129 179 55 7 245 206 35 173 214 86 198 69 118
134 13 151 29 25 201 159 109 69 4 31 137 139 248 238 76 36 109 193 217 4 146 127 185 244 191 79 95 148 110 98 49 227 230 99 234 135 214 182 131 172 149 174 137 229 147 9 24 24 44 170 104 167 242 14 13 204 158 122 108
194 165 105 21 94 134 170 13 159 51 119 174 92 111 124 233 116 120 195 113 189 96 26 157 110 205 174 182 145 250 14 47 150 113 62 137 99 73 62 104 58 125 245 177 251 143 190 34 172 239 206 118 123 74 35 138 12 130 101 79
39 2 26 204 23 146 224 251 182 229 125 43 76 163 173 48 98 137 14 206 122 118 154 13 14 211 68 101 62 221 53 204 208 77 183 24 159 43 35 209 142 163 137 236 63 62 163 45 0 83 179 31 147 28 254 184 90 178 159 5
210 202 47 111 131 224 32 112 88 101 188 253 28 88 241 106 97 133 5 152 99 254 185 76 70 182 120 115 79 69 192 163 3 116 30 11 62 91 95 145 168 215 32 105 211 163 14 82 193 154 234 240 6 0 49 235 245 86 230 85
244 105 98 25 86 143 210 102 199 248 45 99 185 183 112 168 27 84 128 71 19 192 78 98 114 252 195 95 194 121 29 228 95 56 53 237 253 33 80 85 164 222 54 20 119 243 229 192 218 83 98 232 87 26 66 167 90 142 163 191
161 40 151 232 135 2 181 147 17 239 88 43 149 250 151 207 253 10 216 190 18 93 117 91 87 128 237 234 130 85 212 50 71 252 46 37 75 148 35 67 137 144 246 193 153 49 114 202 4 177 163 115 130 128 49 3 118 3 131 142
187 7 123 191 212 70 207 227 77 145 222 183 194 252 101 159 241 184 121 240 161 27 200 178 70 55 192 40 121 160 85 68 119 160 227 110 67 47 40 223 69 115 136 159 33 56 128 20 92 55 105 193 171 204 192 112 212 80 23 123
163 146 161 120 112 173 242 250 49 139 189 0 153 136 26 106 241 202 25 146 23 214 166 117 142 111 159 191 105 100 20 92 255 137 28 102 13 87 211 166 212 87 45 84 217 130 110 221 203 211 207 193 135 241 50 204 210 80 124 122
29 242 75 229 38 152 182 154 64 17 228 107 19 56 81 126 45 148 106 88 166 45 171 24 209 61 62 46 151 243 168 187 194 5 90 235 188 63 87 132 200 130 172 238 63 171 212 105 201 114 160 243 222 179 99 25 80 241 3 128
250 183 19 123 192 206 225 228 240 146 124 13 83 204 125 10 36 27 41 243 168 106 24 248 231 97 226 15 207 23 45 44 248 95 21 19 9 92 10 164 10 162 28 185 32 221 226 100 151 14 93 55 69 255 61 175 75 142 8 89
197 75 204 27 68 5 182 246 56 185 8 228 60 108 227 120 3 179 251 219 29 140 34 51 119 36 56 191 120 98 121 228 31 26 148 245 202 95 254 85 159 59 136 134 14 67 57 54 240 177 151 145 133 113 227 73 102 186 243 33
239 200 59 88 66 60 123 128 71 16 62 54 252 225 173 44 191 33 51 0 52 34 58 61 90 99 41 155 53 218 26 108 255 9 231 108 176 40 173 6 85 186 43 242 196 225 204 133 102 64 177 156 207 129 49 32 97 236 102 52
77 85 65 24 178 135 205 202 100 74 206 151 126 131 249 95 7 60 110 129 51 202 59 56 244 244 16 34 248 49 32 236 55 236 65 92 234 111 145 200 181 117 44 22 34 173 175 188 2 118 69 64 244 60 98 235 214 102 133 123
6 214 254 66 148 245 199 108 195 82 134 215 68 76 89 246 122 208 100 139 208 102 69 35 179 176 116 23 184 182 17 193 38 61 199 15 196 87 76 70 24 155 174 176 38 252 36 88 116 2 208 49 109 90 62 227 182 147 0 28
6 187 65 128 28 40 218 22 199 75 79 75 24 243 239 81 153 151 92 154 167 185 55 211 37 59 227 168 162 7 151 218 100 124 103 102 193 242 14 249 36 233 78 79 185 220 117 184 171 43 2 250 210 100 248 149 114 156 118 160
113 118 159 11 175 43 249 90 183 74 6 124 82 156 113 70 156 246 167 10 48 198 139 21 35 22 163 159 153 181 253 141 162 0 59 117 10 236 149 23 230 251 220 114 18 96 165 79 233 35 252 37 234 100 185 126 112 53 252 0
59 60 146 40 7 137 155 225 202 68 149 15 17 134 130 53 222 252 129 176 189 186 66 72 233 140 59 166 169 178 160 228 2 126 102 217 40 114 224 138 237 119 91 220 92 181 110 56 131 25 110 17 132 88 56 179 242 205 28 31
41 82 219 148 241 13 36 140 173 22 162 159 224 53 109 201 170 135 152 140 0 215 6 172 127 74 247 222 81 228 6 31 217 220 252 201 184 179 69 140 192 1 53 92 72 135 180 35 113 112 206 212 28 178 95 172 124 31 146 235
210 229 78 184 241 35 123 175 148 249 237 161 56 40 156 154 217 226 183 162 172 219 138 176 25 103 16 217 144 0 232 182 222 36 218 114 97 173 217 239 71 74 32 245 55 116 127 233 0 48 110 40 21 143 69 108 67 246 254 68
125 58 251 113 97 6 140 66 168 52 114 108 18 15 82 46 159 15 223 49 77 111 144 0 26 239 228 108 203 39 192 146 185 239 107 30 178 129 129 64 152 11 156 144 0 212 47 186 144 48 39 5 38 177 185 239 29 15 153 152
70 175 113 46 217 69 175 181 106 198 33 247 152 149 4 78 204 51 180 180 72 38 85 251 211 60 144 222 61 21 214 162 119 83 91 85 180 243 247 166 218 159 232 123 36 51 189 205 212 190 135 110 83 43 198 159 174 250 58 112
239 11 164 140 165 80 251 25 88 49 112 179 233 68 176 59 58 35 54 234 124 49 97 224 52 77 222 114 9 48 144 38 244 120 132 248 172 6 250 61 61 209 153 255 28 167 23 102 242 1 94 110 65 73 52 199 82 233 151 221
44 145 93 191 201 52 149 129 169 18 89 106 11 126 59 190 117 230 77 93 251 78 122 243 155 231 80 15 25 93 52 226 132 184 11 197 87 11 86 44 222 17 59 245 100 118 177 162 140 49 149 157 241 25 63 107 143 86 200 162
229 27 61 205 179 251 232 156 48 84 19 141 197 70 26 135 30 242 79 30 137 12 19 151 246 251 166 14 78 56 209 250 47 173 250 77 223 240 57 249 79 215 83 214 183 72 238 246 161 148 50 87 255 9 188 170 226 181 2 216
102 132 129 236 245 207 122 14 189 59 51 138 216 122 1 51 72 170 139 106 236 86 187 62 158 140 197 66 58 56 207 83 161 64 54 17 87 161 191 59 60 46 78 129 172 133 220 197 27 196 90 63 32 198 96 157 255 120 239 53
161 10 18 239 82 37 65 242 4 138 16 196 44 228 192 245 179 46 91 79 254 226 123 248 144 83 55 134 73 216 248 182 99 81 44 163 138 197 14 193 64 20 144 163 153 181 162 254 9 89 247 200 136 189 129 198 243 62 18 49
126 219 237 207 242 162 236 216 103 86 203 95 89 228 163 226 193 13 6 212 251 216 11 222 114 47 85 94 227 90 115 248 227 106 37 11 94 121 192 211 59 198 78 208 138 161 132 141 221 172 114 133 129 135 87 175 195 143 146 150
188 67 230 133 12 72 36 89 68 123 214 130 149 149 1 207 234 49 89 90 29 254 232 153 198 162 85 3 222 245 163 20 140 83 239 60 192 155 111 102 20 247 190 36 200 110 31 69 83 101 101 65 134 184 36 1 16 208 143 161
105 228 75 21 55 157 18 1 28 171 161 74 72 70 216 162 173 124 5 214 6 125 198 129 60 109 247 157 114 9 123 82 247 109 252 38 49 211 217 161 93 129 248 95 112 84 63 37 247 164 174 64 225 206 169 92 122 255 108 251
252 203 221 98 149 240 192 110 24 1 110 255 11 56 129 226 120 181 43 181 68 113 62 117 43 254 180 156 152 250 186 170 136 211 219 150 208 8 67 249 35 205 50 4 153 253 131 181 220 247 80 89 23 63 88 204 50 214 49 162
99 84 151 149 32 226 60 163 120 148 165 38 77 137 87 13 185 148 166 98 23 252 244 20 121 240 236 147 240 33 111 214 156 187 44 196 71 224 50 139 55 156 80 81 105 210 8 9 189 71 127 50 35 14 69 90 114 18 250 101
235 168 137 131 176 136 170 141 233 9 229 196 47 136 89 134 128 26 241 157 250 114 80 190 164 125 69 164 71 147 100 207 185 98 72 194 207 9 148 197 103 25 54 197 213 203 105 224 217 33 203 67 163 239 204 214 196 150 167 28
10 211 12 71 110 4 69 238 140 69 186 194 149 208 16 177 202 182 101 255 26 124 237 115 241 180 51 37 17 57 50 28 161 146 114 96 54 16 187 122 148 23 13 8 41 173 188 183 139 177 23 154 149 213 89 57 16 144 110 208
124 74 213 99 9 65 228 125 13 179 151 207 234 51 120 92 22 204 216 175 181 64 119 12 30 30 221 18 113 129 58 162 41 250 252 182 98 126 79 14 222 226 165 154 233 181 12 207 141 18 179 250 112 246 117 84 114 147 150 136
31 108 248 244 21 217 28 26 124 220 146 94 248 141 107 175 143 55 111 166 72 37 134 162 171 112 48 171 251 29 18 161 68 180 37 159 177 81 115 125 77 215 5 171 76 66 150 89 250 47 31 107 17 114 148 176 49 130 73 37
189 160 92 232 165 39 105 239 155 38 196 64 254 87 205 156 86 235 157 143 90 98 163 182 220 246 139 192 27 223 58 255 21 240 248 168 56 127 10 73 65 252 30 61 87 55 187 85 140 189 32 198 220 47 48 198 105 3 122 222
34 98 97 152 143 4 223 118 15 176 24 155 82 131 31 84 79 51 191 145 39 61 97 158 217 248 118 229 93 48 130 25 95 189 101 122 180 73 178 243 86 103 121 185 97 252 143 170 49 213 249 159 202 99 27 145 58 30 254 224
8 157 128 254 140 125 155 130 211 190 160 208 6 8 127 73 229 3 55 143 85 38 83 49 150 117 103 60 64 1 214 240 174 23 191 215 228 211 255 196 21 234 251 253 22 138 145 127 110 73 190 161 230 92 117 239 16 67 13 158
126 100 165 134 62 16 7 104 241 152 71 160 28 115 5 109 75 178 201 141 10 11 231 103 223 128 91 48 113 63 246 168 95 33 118 202 26 39 58 153 192 142 13 47 191 80 156 218 126 209 149 212 59 195 203 244 241 57 204 43
44 250 15 10 124 71 85 161 78 204 119 193 228 68 212 179 117 198 153 112 251 174 240 119 89 109 218 182 32 49 220 174 108 100 190 219 208 47 215 48 189 57 180 93 141 49 23 253 43 104 204 105 158 147 96 85 192 58 131 68
74 127 187 65 154 5 10 124 96 60 203 113 159 64 46 251 10 22 87 210 128 166 198 93 223 137 107 137 127 230 97 145 89 157 65 105 244 47 62 156 130 228 173 130 102 85 114 45 2 42 141 10 143 33 232 154 90 212 95 65
13 133 217 26 122 139 36 212 117 160 137 245 128 9 190 219 24 177 209 222 206 244 146 87 194 118 88 8 49 72 27 168 12 77 85 14 66 92 102 142 230 31 136 146 23 28 137 147 219 83 100 235 151 204 56 153 205 255 140 80
171 63 211 125 60 215 186 93 31 17 4 60 229 195 106 150 44 244 132 182 111 115 46 239 172 155 166 190 107 115 68 37 17 42 119 100 157 182 58 248 77 67 217 195 74 124 82 0 198 181 242 114 0 254 17 6 34 132 175 92
52 30 122 188 82 141 30 8 104 51 119 176 251 138 55 18 84 82 66 252 158 58 193 156 9 104 24 241 227 240 90 51 209 196 13 232 50 31 181 96 181 152 58 51 3 92 226 35 243 173 106 46 98 90 214 93 236 206 31 119
102 62 210 214 234 60 95 177 120 97 172 96 73 199 251 160 167 92 215 138 117 61 95 252 57 253 248 69 64 224 204 103 27 103 153 73 99 139 168 122 24 135 125 168 121 98 191 236 30 145 75 98 167 166 46 255 39 163 227 6
65 18 206 127 74 136 229 143 52 113 172 119 56 25 50 203 217 92 123 169 19 209 218 185 247 99 142 98 234 93 176 106 71 53 187 225 78 249 58 91 65 202 88 229 85 121 251 214 186 10 56 201 21 49 208 85 64 181 113 217
184 11 208 189 82 198 179 170 235 15 98 105 117 89 16 210 246 166 82 199 215 24 201 98 12 181 252 135 154 61 163 160 231 96 249 143 82 95 37 172 207 13 70 87 150 49 241 118 109 120 252 101 216 89 177 218 222 223 30 168
66 152 82 93 177 80 196 151 87 247 186 75 162 120 146 54 187 183 16 229 153 108 178 225 188 119 132 45 214 145 221 21 118 50 226 107 8 153 33 9 10 84 96 54 132 163 175 119 184 94 210 31 38 111 248 201 52 102 169 204
181 205 204 126 180 165 54 139 44 134 92 61 241 118 156 157 202 108 56 148 23 26 162 180 1 34 218 32 93 184 252 202 103 211 86 167 246 28 91 77 197 7 141 154 41 199 240 251 23 9 170 189 121 202 164 7 218 1 107 24
27 252 148 157 105 80 35 4 189 97 232 53 81 119 187 193 79 109 193 69 172 74 240 202 210 82 230 31 103 219 230 136 3 207 90 62 144 214 250 97 43 55 76 69 150 29 102 145 4 97 145 246 126 0 247 162 171 225 161 15
116 123 163 68 253 57 78 248 119 159 175 35 218 211 118 189 100 221 21 33 76 83 197 87 61 184 91 249 55 64 221 25 55 25 139 238 165 116 52 223 220 195 199 203 229 146 91 56 1 164 50 34 200 247 227 68 11 23 169 53
99 66 19 251 14 83 125 150 199 179 189 248 241 139 130 172 20 30 164 111 88 51 212 48 74 23 177 121 200 55 208 118 12 193 238 13 95 39 139 138 218 206 204 168 129 191 110 63 81 234 183 201 7 25 175 248 111 203 63 131
233 180 4 83 205 245 66 77 143 102 43 136 56 131 244 23 151 109 159 191 152 84 177 89 203 139 143 202 217 245 75 158 236 209 116 177 229 93 134 244 212 212 162 31 108 166 73 228 222 224 111 125 137 1 153 45 215 128 145 57
17 246 98 210 245 137 233 140 206 95 22 55 41 87 71 192 102 190 36 231 105 165 6 64 220 233 21 105 78 111 134 186 17 218 134 174 26 140 77 7 246 37 157 255 76 174 137 65 67 18 244 195 82 107 152 12 56 182 190 29
59 250 80 227 119 119 180 11 177 201 94 0 163 244 82 137 12 22 86 78 122 125 0 102 222 57 85 151 87 179 182 152 10 178 249 138 187 165 94 164 155 208 71 208 216 118 240 106 77 29 43 63 29 232 157 246 128 168 184 34
143 58 126 171 22 73 57 82 97 250 74 100 50 21 166 79 78 120 15 171 125 55 252 223 118 112 113 102 36 226 130 215 226 88 122 225 100 3 13 18 94 16 176 232 230 148 212 57 215 181 33 64 151 197 84 215 47 247 83 33
131 90 62 237 123 150 134 215 198 30 179 26 146 16 196 100 210 223 116 117 124 93 165 12 66 190 196 41 80 64 120 15 50 206 166 95 47 163 196 132 142 174 47 153 44 118 92 254 248 22 230 68 153 95 166 65 188 59 101 104
126 109 63 150 156 234 1 25 215 116 118 253 21 166 42 167 145 202 55 132 253 169 37 176 189 179 82 200 125 183 199 250 22 45 196 5 217 177 59 248 40 108 190 143 99 126 8 1 87 234 56 241 55 224 85 232 56 140 197 130
57 136 180 175 130 233 255 128 250 164 169 10 6 54 83 92 15 5 8 22 186 237 115 37 210 177 130 19 197 28 192 16 18 134 154 180 215 126 107 111 145 198 95 188 11 2 222 205 229 138 77 180 21 227 40 74 209 137 70 138
87 245 136 84 94 103 130 48 253 21 35 90 230 99 160 172 223 198 112 126 191 196 174 13 40 220 142 217 44 55 66 1 19 166 213 153 170 44 135 238 241 38 54 76 183 145 228 119 91 18 222 78 202 120 89 149 74 182 224 252
218 211 114 119 223 35 101 24 188 190 135 140 252 30 145 119 5 94 45 54 247 195 129 83 91 141 13 139 246 179 134 160 116 81 178 173 233 210 168 18 60 197 191 36 90 193 1 51 179 155 75 65 196 216 144 187 3 161 94 50
222 236 54 241 49 53 194 156 111 69 228 100 197 206 3 246 150 234 177 145 220 124 90 35 198 79 119 210 195 211 92 242 249 28 19 34 17 156 80 144 159 199 101 127 11 30 178 230 179 250 139 133 246 16 162 157 138 63 63 190
65 180 151 254 248 58 11 53 243 116 3 12 36 1 46 213 122 28 0 127 34 45 84 110 147 25 44 105 85 94 99 226 32 222 190 154 97 215 229 70 146 197 135 93 133 203 132 184 111 127 226 194 100 78 120 70 143 8 26 222
76 0 63 216 17 232 97 232 130 151 98 18 245 147 141 220 87 1 192 217 105 170 33 253 19 215 232 56 199 234 228 79 245 133 132 23 142 250 12 138 149 46 6 75 219 82 71 7 127 240 199 50 157 37 46 145 226 3 44 132
69 163 89 245 232 56 247 118 136 88 54 240 154 233 9 140 211 205 165 173 48 185 1 96 148 252 71 175 114 222 76 6 71 64 135 86 219 220 193 140 232 99 157 210 91 10 211 97 43 34 174 3 4 77 77 87 148 119 28 49
203 26 210 150 206 182 73 254 120 10 160 100 199 228 226 226 60 229 136 170 238 151 24 75 49 247 162 96 54 123 5 31 11 166 197 195 11 218 160 53 245 92 157 191 128 133 7 84 220 199 101 62 20 157 46 13 149 96 91 42
192 90 229 53 9 100 90 193 66 171 123 140 55 29 224 82 152 86 37 240 76 30 221 54 157 213 229 178 232 12 182 169 204 168 110 67 2 1 130 140 52 153 215 32 110 99 169 251 231 40 210 90 149 206 137 194 136 126 178 255
155 80 216 70 216 60 42 109 163 195 54 70 0 150 36 66 20 62 48 224 125 120 143 104 87 215 88 205 2 60 30 108 37 7 253 184 160 189 75 83 18 54 211 165 50 39 197 145 197 119 71 104 251 233 180 70 177 209 105 164
135 96 155 170 247 24 226 224 169 89 202 104 241 216 51 96 84 187 92 125 127 20 185 83 221 193 79 204 103 236 137 110 201 140 136 242 64 65 77 138 220 187 113 151 64 237 192 140 54 180 69 111 146 71 17 253 152 2 76 196
140 55 193 0 11 212 131 49 14 63 213 6 100 84 17 13 144 15 141 199 164 115 244 208 109 191 238 194 21 34 248 159 99 215 64 75 250 162 213 58 198 253 35 187 80 230 217 67 61 214 19 103 147 128 188 176 8 219 43 106
26 158 40 69 161 119 82 162 95 248 93 175 86 93 232 243 217 84 221 208 197 174 161 155 45 56 135 75 240 106 76 250 63 154 143 118 167 9 81 188 206 213 23 44 153 80 50 225 104 0 33 179 149 183 211 59 63 225 20 139
75 27 228 132 226 86 10 84 77 176 20 46 238 170 32 135 86 186 184 36 190 178 7 131 42 22 212 243 169 68 75 254 23 178 55 62 89 198 118 40 81 152 243 189 53 62 254 35 247 0 161 234 84 185 184 211 250 199 33 88
203 249 159 103 232 20 134 232 66 12 65 178 166 214 217 211 164 240 65 74 30 86 45 197 41 139 12 168 196 48 131 35 69 219 249 15 64 218 245 15 136 138 143 53 126 128 170 68 77 89 132 226 62 1 169 245 66 229 187 131
230 127 73 9 38 43 61 7 102 191 31 134 149 82 228 227 230 233 201 87 24 133 249 99 220 66 35 207 59 251 20 185 124 246 236 45 240 150 153 45 53 145 61 8 185 132 100 254 163 3 95 141 69 121 146 127 104 173 207 240
213 233 38 140 213 102 138 3 202 249 36 230 84 126 122 187 69 47 167 96 212 142 71 141 89 217 112 175 71 99 44 178 241 97 135 148 218 88 59 100 158 43 85 43 153 0 146 70 124 20 67 95 192 32 18 163 247 197 150 179
187 149 39 26 61 98 87 68 220 172 246 0 1 25 59 121 179 157 254 199 78 139 254 190 232 116 90 191 187 118 34 93 64 7 31 120 166 223 161 97 203 58 236 185 52 12 68 76 219 60 14 255 246 108 111 97 167 78 229 59
203 146 33 202 15 168 45 149 12 78 158 23 72 132 234 129 81 235 79 249 225 253 42 86 124 244 62 205 134 198 177 63 136 153 91 115 173 105 126 58 95 9 22 213 138 136 152 70 94 115 102 199 232 207 196 232 81 110 52 181
38 247 114 116 36 209 143 170 57 24 207 172 137 92 24 159 150 243 165 197 75 222 44 18 145 130 184 232 74 36 74 182 96 210 153 179 143 136 17 115 147 34 106 29 95 193 61 65 217 128 188 176 151 1 119 246 89 230 37 91
23 14 23 209 115 83 233 85 132 199 91 137 51 146 225 251 127 61 161 213 38 98 111 204 237 194 150 12 59 119 45 216 227 192 1 235 28 184 85 231 188 161 56 131 248 127 11 79 215 221 223 194 251 24 121 84 213 99 175 127
179 85 192 186 236 13 197 108 36 14 49 159 81 188 62 147 191 206 95 181 47 152 8 133 60 15 82 61 149 211 31 195 104 155 181 27 22 18 224 112 69 151 16 155 181 162 39 35 143 43 24 196 45 210 12 43 8 89 253 92
197 86 238 122 152 212 9 4 60 18 114 225 108 125 239 236 147 186 47 126 122 220 186 157 0 68 94 12 144 88 171 173 64 150 251 249 252 64 245 184 162 72 235 66 101 100 86 107 151 247 92 103 211 120 237 211 26 217 170 71
232 113 212 248 76 192 245 207 66 32 249 34 24 42 223 49 89 109 132 112 49 245 37 252 179 211 202 114 161 226 247 138 247 15 187 42 215 189 92 190 76 15 198 121 190 53 186 44 157 208 199 229 31 37 22 129 231 86 88 81
90 83 252 140 78 167 208 124 104 86 181 20 58 182 11 59 101 180 17 15 78 115 226 108 123 75 29 13 142 30 57 30 130 16 139 197 103 29 147 52 218 119 48 22 47 57 137 69 106 233 162 172 44 134 188 0 203 23 98 22
191 138 98 48 120 97 75 65 172 166 73 135 91 120 216 195 179 3 81 58 104 80 156 132 197 218 46 100 47 170 123 11 61 213 253 208 29 25 13 12 247 91 21 216 115 75 50 85 27 19 6 223 57 147 101 44 78 127 54 251
131 78 84 22 229 76 176 190 178 251 67 66 0 166 4 242 250 93 243 185 49 62 105 154 73 231 68 110 154 40 112 239 216 2 15 85 218 75 214 253 65 43 87 163 217 37 247 187 244 116 250 232 192 151 119 246 4 207 55 120
105 97 222 72 31 7 234 224 187 31 212 29 127 186 143 150 31 80 200 205 130 21 142 16 54 226 225 79 236 242 191 242 150 154 6 71 141 191 61 161 155 26 142 232 59 99 67 98 197 165 86 142 228 161 25 123 202 73 55 249
176 204 62 134 244 151 143 215 185 177 164 58 105 114 135 24 252 251 134 56 1 122 188 126 76 106 188 5 204 89 183 82 108 142 51 220 20 45 123 96 192 237 113 47 81 23 32 248 135 112 99 102 110 221 3 196 97 42 138 132
238 29 34 247 35 108 242 6 179 108 220 9 148 183 50 141 24 45 8 61 21 127 132 76 144 154 156 126 131 209 86 153 62 124 167 117 109 6 22 11 235 40 24 186 164 126 146 83 218 198 131 184 249 247 91 185 61 165 248 215
104 76 18 234 96 40 198 56 51 63 135 15 124 14 40 56 99 17 19 86 98 44 113 82 104 20 112 109 75 48 77 110 79 24 170 144 200 74 82 248 184 162 63 190 243 84 192 34 110 189 19 118 72 60 176 93 114 76 68 28
173 58 204 59 36 74 124 249 114 73 62 71 233 195 101 31 118 223 205 39 193 241 126 148 33 135 114 208 126 92 148 82 187 198 54 92 120 212 1 103 128 227 39 113 141 152 108 19 27 233 109 214 92 34 178 115 253 241 251 213
183 150 14 192 15 138 60 97 152 140 176 76 26 114 165 16 147 122 72 191 185 9 117 77 97 81 131 168 63 249 126 42 106 209 163 72 89 211 139 129 162 212 9 242 124 162 46 181 10 35 100 170 12 112 106 24 144 234 123 13
234 67 121 44 22 41 137 115 212 73 167 67 219 254 185 43 219 217 130 9 83 30 133 221 78 6 202 52 173 11 76 160 25 69 142 6 33 188 200 47 90 140 47 124 206 41 64 112 24 143 173 5 249 215 53 102 152 230 115 92
229 227 230 199 56 201 114 238 231 114 41 20 48 120 28 211 168 47 188 155 236 122 44 29 128 70 122 0 85 198 255 190 216 45 54 22 165 231 42 108 53 13 64 24 254 81 109 227 198 87 162 115 236 21 202 234 194 27 162 199
197 234 24 58 124 126 71 61 72 83 253 126 208 244 232 3 128 242 116 108 102 38 147 0 187 2 109 232 193 150 33 206 15 49 45 245 64 94 65 226 117 230 173 198 84 100 245 201 199 228 193 60 246 33 50 189 86 62 80 230
184 57 9 216 157 139 3 96 139 189 150 144 208 80 74 22 35 117 105 172 20 197 85 195 166 187 222 151 95 86 80 105 97 172 157 184 83 28 7 202 116 211 44 137 38 191 233 48 112 49 10 180 214 16 146 20 5 114 17 247
6 69 167 76 174 28 252 36 180 148 202 170 235 137 79 209 253 16 244 224 230 107 129 172 71 195 248 20 138 166 76 105 236 110 22 5 27 215 44 241 43 220 65 220 73 250 158 89 127 25 12 21 2 22 187 220 89 82 252 248
204 241 120 33 233 17 55 136 237 89 56 97 218 88 19 2 75 39 9 193 93 181 118 248 252 41 12 65 26 201 15 25 185 71 41 14 158 127 42 136 93 80 174 37 158 144 129 150 32 252 240 90 90 15 181 131 56 23 84 58
229 39 125 126 31 244 244 166 170 197 208 171 128 42 225 71 22 22 237 78 31 32 237 89 162 49 121 182 167 5 123 121 12 202 106 92 48 8 155 247 12 166 21 62 126 238 0 1 196 111 202 24 252 51 138 153 135 126 254 240
25 50 10 38 167 121 231 70 68 123 25 14 24 198 100 168 181 73 220 38 67 8 16 69 211 230 108 23 156 12 55 208 223 93 229 120 218 57 18 174 77 220 22 186 105 182 159 151 126 3 237 160 32 177 112 11 134 231 17 143
237 180 131 220 98 131 4 9 229 198 67 25 184 1 13 95 29 28 187 38 86 198 71 22 163 47 103 229 253 78 127 40 238 20 16 60 58 48 125 132 163 235 242 141 83 89 92 235 255 90 45 39 125 132 4 103 71 1 25 52
199 107 171 15 201 104 28 155 182 49 66 50 120 180 26 107 146 191 197 170 117 66 56 157 188 111 6 233 117 44 93 72 66 36 94 216 166 200 157 152 77 158 1 241 221 244 19 146 110 140 42 99 8 90 16 151 111 74 175 171
133 41 113 230 218 154 248 35 8 225 149 96 136 164 201 234 66 85 56 18 31 56 87 103 80 164 81 129 52 148 158 139 198 205 143 101 113 245 153 223 47 92 242 149 239 230 181 73 159 90 187 244 70 191 74 53 160 145 86 60
84 204 60 55 139 93 37 148 32 224 244 136 97 31 8 204 57 71 57 179 214 146 182 85 190 155 232 34 63 103 242 216 87 247 25 247 177 10 193 145 188 117 32 57 77 254 137 72 54 225 28 156 178 172 154 222 30 97 51 106
67 174 167 48 165 61 219 106 60 177 173 235 181 150 8 42 60 220 204 139 177 195 156 213 44 197 78 232 84 198 243 84 164 32 65 230 128 254 92 121 39 218 171 174 176 123 203 24 220 200 84 223 38 171 149 176 111 103 217 144
206 59 106 238 195 240 189 211 182 147 32 140 153 66 248 204 7 6 230 171 168 30 35 251 37 217 189 73 74 98 78 188 107 2 143 24 26 190 226 80 42 118 33 83 82 116 249 198 226 50 96 249 247 148 152 44 86 51 119 231
