213 247 120 92 73 164 20 6 61 134 98 233 49 32 101 140 228 89 229 141 227 63 142 82 153 39 45 55 125 61 251 102 239 124 217 230 40 190 148 12
213 234 193 102 53 215 185 192 116 183 130 128 191 217 107 141 30 205 161 223 65 25 119 38 120 167 158 16 12 57 133 224 108 171 192 9 181 189 151 234
232 4 143 126 206 160 61 44 163 29 191 201 172 245 47 202 233 176 81 197 106 46 184 181 164 96 96 66 64 101 254 224 230 227 241 146 229 11 104 102
119 71 62 173 16 134 11 145 47 212 219 248 201 166 53 154 166 253 213 33 52 203 197 236 220 107 129 132 237 225 60 152 120 78 63 77 140 74 78 78
142 250 64 232 18 58 139 54 39 4 24 216 199 167 61 178 194 130 25 49 222 9 46 62 190 53 124 208 71 48 221 95 21 243 164 91 247 57 190 130
214 242 47 116 50 6 15 132 42 195 177 214 92 101 119 208 156 167 83 125 111 148 214 246 154 121 27 52 105 44 164 102 34 220 21 255 194 118 220 128
89 174 147 162 191 222 159 38 183 254 165 199 22 41 188 126 119 63 133 61 157 138 127 168 90 230 80 14 114 198 226 208 220 187 35 83 144 246 144 191
100 6 73 26 3 14 129 140 251 231 209 78 107 94 124 33 88 102 224 114 111 176 208 203 245 219 12 246 61 67 114 247 199 120 238 23 94 182 247 84
43 49 165 221 36 85 48 53 122 237 78 102 206 142 114 232 119 225 28 44 252 35 122 52 247 233 127 206 43 167 13 95 104 200 234 49 161 28 14 116
151 142 171 247 241 182 191 95 32 204 227 183 166 173 175 41 79 76 2 54 69 91 68 105 182 237 81 204 49 137 155 63 180 237 13 179 105 85 164 63
25 239 198 96 210 6 59 171 119 69 62 210 118 0 242 23 169 206 1 52 247 165 251 74 134 252 41 21 52 59 219 214 222 246 222 163 31 30 183 128
40 213 5 157 86 186 229 57 11 17 211 218 77 162 110 51 220 101 213 155 139 209 129 32 106 106 65 95 136 55 104 165 223 237 74 96 59 170 81 71
201 42 144 39 225 244 109 138 194 111 105 80 154 213 219 63 166 186 91 90 67 8 147 196 232 249 97 225 223 57 5 110 189 221 120 17 105 193 208 74
141 171 231 238 72 133 68 239 230 41 86 94 239 147 130 2 153 89 210 231 67 45 73 224 23 120 89 97 242 81 174 33 32 100 199 107 228 65 21 75
180 88 60 156 234 106 47 52 177 200 161 211 162 170 228 5 234 165 131 66 234 112 134 186 66 220 169 50 34 211 4 81 248 205 142 189 64 165 94 62
209 222 59 144 130 227 108 97 103 171 61 65 209 24 188 48 178 211 90 49 2 1 150 81 105 97 75 38 72 169 178 1 204 241 166 147 142 51 227 31
219 162 233 131 53 216 13 96 203 25 20 6 134 155 176 24 149 203 214 162 185 124 65 61 71 251 45 100 119 123 44 141 18 114 48 35 212 207 17 119
115 105 196 95 143 177 148 126 64 187 31 13 238 220 37 39 109 33 20 14 177 106 83 146 138 198 229 166 125 38 40 46 91 68 250 200 211 126 49 162
207 24 77 131 177 169 119 177 247 184 151 124 50 232 17 128 223 237 144 174 1 112 204 196 72 70 63 243 97 199 10 162 154 240 242 119 31 241 105 102
254 103 210 245 31 194 80 68 175 64 95 69 65 240 13 203 206 5 36 223 50 166 226 66 123 53 169 143 0 179 36 17 202 103 201 183 56 242 19 79
205 7 66 229 127 231 64 11 14 6 127 207 115 130 86 149 151 222 137 17 166 49 6 122 30 56 90 193 125 4 172 149 108 151 37 163 195 17 237 221
113 2 231 152 131 237 89 153 69 147 165 46 90 48 86 69 68 98 172 7 208 185 212 90 29 160 213 128 42 120 175 122 118 224 160 39 23 183 247 139
142 125 250 216 135 130 181 238 222 215 175 145 187 192 183 194 29 99 218 159 154 81 106 228 149 152 46 198 238 174 101 82 178 76 200 38 182 2 33 39
200 168 7 122 53 219 92 43 9 105 14 57 211 105 243 199 146 192 238 101 191 29 240 60 225 96 200 129 86 82 108 121 64 72 206 199 235 217 87 205
27 154 125 236 241 32 33 92 141 208 216 62 100 183 225 34 222 103 101 31 243 255 19 154 85 219 93 130 211 8 217 91 90 31 43 117 33 167 161 197
166 88 116 181 112 79 65 10 234 121 53 30 0 217 205 185 129 235 134 180 12 155 232 237 152 64 72 80 187 72 28 142 205 211 120 147 225 30 194 221
8 224 46 27 71 27 228 1 141 216 174 114 150 243 139 24 41 114 27 174 72 161 139 217 251 203 89 229 69 190 160 247 199 140 242 255 111 183 147 251
173 172 99 90 19 244 212 56 31 158 1 195 103 110 125 133 91 127 20 9 87 61 155 123 251 5 128 107 141 252 27 216 208 89 161 241 239 234 70 104
69 152 141 164 44 209 168 176 42 18 68 83 200 69 239 231 180 229 160 46 91 184 112 120 188 43 47 50 126 9 193 32 117 182 103 73 220 245 222 71
36 196 116 75 201 123 232 27 236 55 5 104 64 41 114 158 54 117 34 85 198 188 67 16 126 61 56 60 31 94 4 41 45 168 7 51 148 14 3 210
10 239 94 243 189 212 138 241 230 113 218 66 169 208 1 66 67 159 178 129 254 78 60 228 16 181 182 85 103 52 184 128 51 96 144 196 136 255 181 247
159 74 20 139 68 7 214 243 108 68 239 173 203 198 154 34 10 123 84 21 235 30 11 251 169 182 156 104 87 234 53 80 139 20 133 167 123 191 239 101
146 251 190 109 61 246 129 226 78 52 205 98 253 252 249 219 71 227 57 56 42 56 86 46 103 193 58 60 100 205 91 77 156 146 198 165 153 145 184 129
249 35 212 236 189 192 90 138 209 148 25 175 133 101 96 83 33 248 231 168 35 201 62 107 222 117 25 156 62 196 239 18 152 80 147 180 31 188 67 204
74 63 252 24 20 228 185 151 201 87 75 193 90 116 63 94 202 211 59 229 174 27 14 61 239 77 95 38 223 227 50 175 230 0 95 19 148 68 226 148
70 94 79 188 114 99 7 15 119 11 175 88 25 213 189 190 94 134 15 8 170 135 41 175 124 232 122 195 2 130 129 110 163 77 170 45 123 142 25 17
22 158 35 237 193 234 236 225 221 2 243 193 47 116 139 244 223 84 73 183 95 128 157 157 113 254 99 139 171 16 232 159 212 227 50 190 227 225 122 112
46 67 217 121 189 26 129 111 82 161 24 127 192 218 212 9 110 216 29 72 88 232 97 81 168 137 202 133 140 175 129 246 43 47 230 24 12 185 42 98
156 22 82 19 44 190 30 241 29 241 27 182 163 154 132 227 14 21 244 105 20 254 5 39 44 68 57 87 6 120 89 22 84 209 43 176 250 27 100 97
150 152 227 219 224 71 45 117 228 166 28 243 18 233 112 6 78 37 128 176 180 184 212 187 142 62 110 38 163 103 114 124 197 149 168 33 11 39 189 177
242 194 15 240 103 180 200 111 211 113 152 2 91 69 152 192 58 41 234 98 253 57 97 154 171 59 240 238 248 101 191 9 23 39 96 0 24 61 240 242
82 205 184 23 34 116 85 35 25 182 25 224 114 110 70 37 62 177 15 155 169 112 175 156 44 140 253 247 99 2 80 157 161 140 28 65 1 254 226 228
57 6 16 233 20 209 173 167 223 91 224 172 174 107 109 238 235 177 99 40 228 67 139 83 24 74 36 75 123 133 60 76 222 243 13 85 177 194 254 220
36 18 217 255 182 113 46 231 182 50 99 37 183 148 11 234 226 23 169 77 102 205 162 129 154 36 224 179 91 90 250 25 32 65 65 158 43 39 213 57
1 250 133 153 225 42 103 154 114 250 203 99 94 166 106 101 1 20 89 26 181 113 183 1 233 96 81 105 21 110 246 1 2 63 61 26 227 3 163 239
87 91 153 219 162 71 39 138 174 224 238 156 110 38 203 45 38 97 3 74 68 104 230 121 103 245 21 167 224 226 158 40 76 241 88 23 6 246 21 90
248 249 30 107 43 111 37 160 39 217 181 49 235 122 71 142 83 251 158 102 179 128 75 61 83 101 40 101 118 119 65 222 70 125 54 161 20 241 121 229
228 27 3 115 215 124 201 6 17 86 105 169 221 138 172 213 100 84 8 191 160 174 245 161 132 169 204 105 132 83 202 137 45 243 140 36 131 7 170 52
121 11 72 117 169 195 193 122 94 198 55 16 185 90 105 112 114 167 145 243 220 118 68 203 42 192 227 142 154 140 57 25 176 28 113 154 227 242 24 141
166 232 242 215 187 177 161 125 97 46 152 35 241 54 197 225 19 171 93 88 52 234 146 92 219 58 196 73 190 179 42 30 28 236 153 82 119 75 70 5
24 118 113 61 90 190 171 59 49 164 208 145 180 243 137 120 32 197 110 146 163 110 118 35 240 237 76 188 34 124 167 102 20 236 200 41 69 35 97 58
31 150 102 62 52 16 111 51 114 58 159 121 10 128 136 42 152 160 234 191 130 30 11 147 9 143 127 106 129 206 192 253 92 129 173 126 32 153 124 98
108 45 41 12 179 99 103 229 239 13 150 105 50 6 237 102 179 185 174 18 78 228 37 60 195 193 40 213 148 161 188 123 8 67 195 240 143 162 18 248
20 161 40 6 116 54 110 110 73 48 157 234 246 125 38 71 3 0 91 149 206 254 133 195 173 234 29 216 139 174 11 215 195 207 87 41 144 5 217 40
181 200 70 222 171 212 25 255 21 57 102 244 99 92 113 214 7 174 171 208 224 233 37 30 164 198 84 42 188 57 93 114 144 162 141 63 165 110 234 28
149 203 70 235 221 177 189 197 211 6 63 248 55 137 218 203 159 75 148 73 75 123 199 48 70 176 218 6 224 172 225 115 252 72 92 213 4 158 168 138
40 225 146 210 67 16 71 4 194 91 255 95 173 152 145 37 29 209 132 68 140 44 13 26 235 71 16 248 214 233 168 172 79 222 165 81 174 143 164 205
168 22 59 6 55 36 126 142 3 197 24 83 161 113 29 243 40 146 243 72 13 251 210 227 170 6 12 2 130 142 130 91 178 70 78 248 241 75 125 102
229 202 103 21 228 248 195 86 133 20 40 241 160 52 82 21 44 163 136 223 30 169 70 222 59 21 97 211 142 122 80 174 210 233 113 41 68 90 10 142
230 148 108 197 134 181 113 207 96 143 154 89 32 201 82 236 150 139 135 85 196 172 164 132 162 94 12 158 16 150 204 25 171 108 65 208 143 38 148 107
11 130 128 58 242 236 155 78 142 57 51 222 213 142 242 19 196 235 17 146 200 224 187 96 64 171 148 160 16 34 135 96 8 77 65 60 180 17 148 252
226 182 186 189 246 123 168 18 128 230 204 18 29 46 91 156 56 81 224 33 132 142 92 172 26 103 143 164 22 169 97 73 235 130 207 102 10 2 165 244
109 84 8 52 103 74 175 223 238 112 59 229 116 119 0 234 44 25 178 215 221 220 237 30 27 66 92 8 106 182 203 29 227 57 84 12 152 5 204 221
97 18 66 177 131 108 54 199 103 75 205 125 151 163 254 108 200 110 226 30 214 83 186 86 96 107 124 57 233 61 188 219 10 163 239 249 55 1 143 252
199 196 145 194 133 5 186 80 144 79 203 150 137 149 189 6 158 55 19 156 183 205 225 191 15 205 95 214 240 28 50 51 64 184 155 1 86 121 1 75
66 111 146 179 116 27 47 70 163 226 9 127 146 143 84 21 159 208 159 126 7 147 223 162 45 209 26 94 212 83 167 2 160 191 168 135 167 43 243 83
110 10 18 173 199 156 106 138 134 122 141 34 65 5 211 21 82 158 100 182 245 41 82 90 206 152 123 61 137 96 77 85 169 61 189 168 169 175 205 72
142 89 81 25 228 177 115 192 115 131 23 63 193 223 92 1 0 246 229 57 54 62 42 174 37 147 58 166 29 38 97 110 151 200 218 210 222 133 197 187
222 104 7 215 246 15 243 252 17 241 196 18 115 15 72 107 196 108 144 251 35 110 238 142 39 160 81 214 125 2 179 50 209 173 44 145 120 96 163 44
64 223 153 189 54 19 96 249 193 70 176 130 140 24 206 244 211 4 81 26 185 8 69 128 209 166 109 236 236 214 228 73 192 49 101 213 126 96 192 233
206 232 191 15 95 40 149 18 44 230 171 123 217 176 56 78 50 141 65 145 13 240 49 140 247 57 185 221 86 174 88 128 172 56 215 2 175 109 42 204
217 93 232 96 188 203 70 50 224 1 79 86 37 23 205 138 147 74 56 183 118 41 119 31 2 4 254 10 175 22 250 130 7 68 44 178 29 172 250 182
198 114 173 31 74 153 248 95 70 87 23 216 194 159 239 110 255 179 120 118 81 55 45 192 9 190 212 205 1 97 155 252 120 61 156 92 151 199 146 16
222 55 85 105 199 117 245 106 213 126 223 67 10 73 183 16 122 214 116 116 155 166 129 246 59 65 3 186 9 0 84 220 198 191 48 177 0 221 158 196
154 106 110 150 121 173 20 229 113 238 9 46 21 208 93 26 67 170 118 58 116 65 44 111 168 225 241 216 202 97 205 81 79 14 65 200 132 212 22 202
12 206 214 81 99 80 90 7 239 74 194 155 114 96 162 244 99 113 45 152 185 76 55 37 14 212 16 216 255 122 191 87 184 138 40 21 181 200 187 187
44 101 68 240 232 196 89 222 245 184 36 114 28 117 93 200 146 133 30 170 72 169 154 151 94 172 128 212 154 86 112 184 95 86 42 176 91 254 28 180
138 6 47 18 86 178 45 226 134 131 109 169 226 203 192 125 248 101 147 244 35 161 129 122 35 5 245 99 109 221 45 251 115 213 178 5 216 34 209 54
24 254 30 163 14 35 6 251 11 35 46 43 103 75 64 245 124 177 144 27 125 73 227 52 44 93 145 38 154 86 90 130 61 56 108 147 210 159 172 54
70 125 75 185 189 88 235 130 94 240 48 193 152 155 71 36 165 82 93 130 170 128 14 118 27 118 161 177 167 95 190 194 75 11 211 150 174 109 200 186
214 0 58 142 11 206 152 52 152 27 199 28 3 84 181 125 170 43 231 245 223 107 85 26 195 243 105 101 213 204 53 254 98 205 61 249 126 16 23 236
172 31 25 49 161 171 57 97 224 170 123 138 172 23 240 100 47 251 62 4 250 171 25 47 4 102 98 72 221 106 41 24 144 118 105 190 108 141 37 181
119 79 40 124 241 108 114 136 11 41 168 111 54 176 183 110 132 200 188 109 185 192 194 175 244 233 216 161 34 99 228 140 228 142 80 174 142 148 33 56
64 200 185 233 19 249 226 171 118 74 209 202 59 178 240 39 168 96 179 192 217 7 200 74 63 195 102 244 125 220 236 225 248 174 221 114 16 231 133 86
36 145 206 82 146 97 236 170 223 138 2 218 124 118 87 14 87 222 176 214 27 190 16 202 248 152 83 161 85 197 164 130 94 153 250 140 131 56 189 90
49 94 223 151 218 50 2 159 72 161 210 127 162 129 60 84 201 251 202 196 188 19 244 52 77 121 108 247 101 210 87 131 98 8 111 117 141 191 60 115
189 17 197 131 13 109 159 17 50 114 71 157 108 158 128 39 250 40 254 150 244 141 4 236 189 171 16 192 99 51 108 107 98 207 85 59 5 46 95 213
120 75 144 47 96 72 229 57 242 51 81 199 66 189 83 5 254 145 188 195 186 72 65 31 66 208 180 73 85 88 16 140 190 136 186 6 9 38 153 208
53 252 70 17 172 32 149 202 197 188 226 225 75 247 136 87 239 92 150 11 23 181 244 132 62 131 52 157 9 127 189 75 191 123 130 173 243 25 99 168
130 57 88 237 33 4 232 221 156 36 220 100 94 122 95 71 14 205 250 2 245 93 251 111 9 64 125 221 66 226 98 180 87 146 96 177 49 249 82 65
20 15 124 232 114 4 47 5 140 250 235 19 46 172 201 13 220 69 71 63 198 48 152 137 87 240 172 44 18 233 97 28 126 156 229 77 51 159 87 163
101 211 92 82 31 64 110 250 44 185 73 104 139 56 130 198 179 202 39 9 176 217 47 34 40 71 134 105 6 76 251 33 68 221 224 233 168 188 17 5
3 130 17 110 203 142 116 76 70 143 243 149 26 39 55 223 176 142 148 56 178 76 160 228 141 155 141 8 139 216 92 67 200 131 247 234 205 114 33 93
146 144 207 57 7 228 144 221 43 22 74 209 96 150 167 227 177 170 164 143 107 57 127 184 68 62 167 175 53 250 48 165 249 168 222 138 186 64 197 222
104 229 48 162 250 60 47 119 56 15 48 32 115 113 226 193 37 171 217 119 255 83 82 12 151 127 180 115 123 224 247 227 251 203 102 88 79 87 47 187
133 112 191 106 47 118 233 84 104 190 208 182 100 152 19 248 233 57 225 125 200 234 13 146 150 210 60 32 60 76 88 145 131 82 106 179 69 144 164 190
156 104 19 226 147 26 156 208 217 161 16 82 235 33 34 112 83 179 247 207 75 244 122 30 170 132 127 112 70 194 185 205 39 59 28 16 135 29 209 135
22 90 253 161 90 115 30 236 207 54 210 60 195 90 152 94 61 157 227 143 37 92 114 133 233 48 92 191 62 225 70 235 89 6 135 175 101 105 231 8
60 141 163 171 238 197 38 86 227 223 208 46 48 26 125 6 213 201 64 38 213 42 4 248 232 245 209 239 57 69 213 44 234 150 130 81 234 140 23 182
94 132 113 232 177 212 212 243 3 20 86 99 169 203 92 125 104 129 78 32 116 190 197 149 1 96 81 168 157 180 154 209 88 227 220 221 67 201 178 240
93 55 51 124 155 39 25 56 73 60 57 43 20 35 95 190 168 4 145 34 30 11 41 199 167 0 19 129 216 46 153 234 81 6 152 30 135 232 206 27
175 46 89 46 18 147 13 94 164 30 4 168 226 62 228 229 234 65 242 35 168 207 234 4 169 89 243 195 44 61 25 59 178 213 50 139 9 164 212 81
103 87 141 74 37 170 248 99 46 1 64 252 242 220 51 119 200 158 47 165 43 148 59 176 157 44 251 143 179 24 92 109 209 176 125 227 213 31 112 80
242 112 146 50 183 70 79 242 20 189 238 134 59 119 162 110 14 208 75 77 186 213 201 35 43 144 82 250 213 178 105 171 109 82 130 230 226 21 231 127
113 222 173 21 49 20 127 25 78 144 81 104 115 74 220 33 110 57 59 45 33 57 138 121 253 244 83 20 212 89 130 201 206 28 138 56 104 56 90 56
179 131 133 61 38 220 102 90 211 187 251 21 172 133 139 175 213 13 138 50 56 204 220 195 243 151 62 80 100 237 35 121 150 250 45 212 232 116 247 169
242 60 193 214 127 212 7 201 208 39 19 98 139 8 215 252 237 31 240 140 166 25 118 62 191 115 36 163 102 152 51 193 177 102 38 166 168 84 31 243
103 250 50 79 38 27 54 97 228 189 12 226 47 52 157 33 53 89 64 219 150 149 107 117 16 210 34 126 41 212 19 242 147 41 58 237 147 13 137 219
143 131 210 156 67 212 246 164 184 187 209 151 146 163 197 46 215 224 131 118 46 254 84 40 188 8 108 19 247 124 252 201 91 175 96 173 85 193 92 81
29 9 175 187 96 162 232 132 100 237 22 5 91 89 68 20 165 11 121 108 68 204 66 30 177 74 103 72 215 93 71 245 169 98 147 94 175 208 90 29
158 249 63 244 249 36 53 181 205 152 227 160 34 155 102 250 148 138 121 100 22 172 249 97 190 236 60 116 136 17 137 72 163 174 198 37 206 42 162 13
166 60 107 120 11 254 11 87 151 125 37 71 23 37 56 192 120 126 122 135 181 124 48 83 176 57 180 202 203 77 139 35 158 197 142 225 172 7 9 239
175 191 109 214 138 250 197 28 109 184 135 38 32 252 45 226 226 35 255 35 62 155 151 131 240 236 220 86 28 220 143 147 188 163 241 146 104 199 172 196
24 186 37 27 197 166 252 131 107 7 239 52 236 220 138 125 255 144 121 190 248 113 171 113 87 33 62 150 9 249 43 21 41 174 157 188 18 39 239 175
214 163 192 246 142 128 255 116 217 156 19 182 7 133 242 86 48 9 101 248 171 192 90 84 146 48 8 191 126 41 65 59 165 206 186 175 214 182 52 139
27 14 230 193 33 91 60 165 195 47 86 4 96 194 149 143 196 96 67 226 162 109 145 174 150 175 170 80 110 151 81 139 141 34 182 160 37 15 85 82
69 203 116 69 139 248 63 171 41 137 225 146 30 229 103 212 199 232 38 89 94 12 65 166 132 197 213 135 116 245 92 61 30 14 225 35 82 81 232 155
26 234 118 89 38 177 160 117 67 51 83 222 99 238 202 120 85 135 220 238 122 109 142 245 211 92 101 76 119 205 194 42 163 133 96 172 170 117 211 20
193 41 220 215 92 40 20 154 198 198 53 23 166 88 19 78 87 40 252 71 102 217 252 53 180 251 99 105 86 219 80 195 187 250 247 230 135 173 109 185
218 14 199 183 85 104 209 67 171 55 53 186 39 20 0 165 174 117 230 63 193 165 130 58 112 35 140 75 42 164 44 126 47 52 205 17 99 66 143 37
247 32 29 137 80 213 172 177 127 173 122 136 244 220 164 100 45 200 117 87 119 137 235 173 173 89 108 217 34 227 137 152 170 187 250 67 85 104 31 191
232 60 188 40 17 153 184 217 118 142 236 28 75 226 34 237 59 207 26 176 83 109 51 75 252 181 72 241 82 97 52 117 150 242 35 221 131 140 99 186
22 219 51 197 122 113 90 152 36 133 103 248 94 5 241 132 116 179 222 210 26 138 4 188 71 223 113 88 224 120 192 244 165 197 6 210 245 144 17 114
6 177 196 5 27 183 229 16 34 164 179 128 39 145 203 78 25 123 107 123 36 1 83 25 179 169 144 216 216 23 13 177 60 75 86 123 246 234 14 31
3 15 191 30 108 182 233 79 100 36 171 255 117 180 40 230 232 29 197 37 16 136 160 237 201 48 216 9 28 144 100 58 239 119 102 158 57 150 194 14
46 88 145 1 72 133 157 1 22 74 230 109 178 231 246 245 237 124 115 17 86 174 251 253 80 7 210 194 71 105 188 21 68 18 103 107 3 43 255 99
60 146 57 250 218 169 209 246 222 204 5 163 41 198 83 223 141 240 125 13 22 176 176 142 229 117 112 151 31 6 96 206 219 13 50 47 182 228 11 64
69 126 177 20 113 86 197 166 199 225 100 33 25 237 14 214 11 54 204 221 182 188 14 79 61 181 18 128 178 71 206 235 202 106 186 177 28 123 108 69
84 231 222 69 250 28 158 4 69 20 237 209 40 85 97 243 207 244 106 18 207 34 206 117 242 200 117 76 48 154 109 196 185 50 54 156 70 119 95 187
236 21 32 253 223 167 204 28 101 84 227 109 221 19 59 75 126 112 93 202 9 77 4 116 117 224 22 205 237 227 134 6 61 225 159 37 80 176 192 126
100 253 68 169 86 85 45 161 62 208 174 36 4 195 110 43 120 112 164 227 149 115 99 97 104 224 252 20 147 242 81 10 205 112 167 176 198 53 159 17
202 24 136 165 164 214 246 133 220 111 19 243 40 237 22 201 231 76 157 142 193 84 46 222 11 219 173 45 143 243 87 28 200 1 28 28 171 108 185 74
30 13 88 237 243 24 147 32 19 176 154 107 202 248 184 31 94 251 13 114 6 18 13 122 37 109 170 124 156 155 62 155 156 0 150 247 73 247 157 227
204 134 228 108 220 46 129 156 43 228 115 31 249 154 194 150 47 79 96 36 8 58 249 180 58 206 75 8 241 193 242 121 152 203 102 144 133 131 172 12
200 154 56 41 40 167 218 191 228 163 87 218 51 162 113 119 37 249 188 140 110 223 124 217 96 23 204 86 81 226 39 169 93 42 153 178 164 213 162 139
197 239 11 161 31 115 96 201 242 182 140 32 198 30 145 214 28 76 110 118 185 74 185 107 227 219 82 2 168 87 161 63 16 30 162 93 210 212 40 210
45 162 62 126 137 124 135 252 85 152 60 102 176 207 179 19 207 9 85 194 233 119 140 191 130 40 50 167 193 254 98 67 187 21 79 153 26 158 23 215
22 47 146 81 15 69 41 8 159 217 216 39 139 178 99 251 204 82 197 2 90 93 59 244 94 80 122 79 9 30 78 167 3 74 152 121 14 16 38 84
190 94 139 199 6 254 74 196 84 189 105 17 46 167 140 63 8 31 132 100 134 105 139 84 121 69 181 72 211 141 239 172 131 194 202 107 37 14 32 179
107 45 212 122 8 213 61 133 61 201 158 216 214 196 13 209 50 46 62 135 142 5 116 81 39 13 138 58 100 133 232 244 186 33 36 18 250 94 237 56
21 224 234 165 218 232 211 171 13 85 203 149 205 119 78 65 10 57 159 246 71 146 93 12 245 41 11 5 15 147 121 92 164 137 138 193 90 146 182 95
72 63 1 22 27 97 135 178 78 196 13 143 124 203 119 236 123 233 145 234 245 177 101 208 152 70 146 168 70 92 181 229 73 184 23 183 222 88 135 82
79 200 120 198 29 123 245 22 107 198 205 7 75 255 144 87 239 237 60 158 218 13 80 9 205 184 71 43 16 28 81 79 230 229 193 239 189 152 139 1
234 56 163 234 231 156 110 13 39 166 17 122 205 65 155 80 56 139 125 66 98 141 112 103 195 79 78 24 59 45 34 8 204 10 60 210 215 99 221 0
20 210 85 232 98 88 203 225 117 96 53 230 98 61 14 134 126 204 52 103 44 99 166 171 210 18 209 211 122 219 217 247 112 60 107 222 18 48 108 79
251 39 126 191 19 131 158 234 215 116 207 187 167 39 144 216 74 83 18 164 39 46 233 137 132 10 144 4 42 240 47 4 30 34 156 109 109 31 94 176
251 175 238 212 139 197 183 89 234 239 83 117 62 77 210 201 241 81 93 103 21 72 69 93 69 195 198 189 70 194 189 62 168 187 246 85 80 71 66 151
55 254 120 41 181 236 83 70 115 193 110 1 67 124 17 212 65 11 98 246 172 215 27 220 137 165 135 77 164 202 160 25 64 195 209 192 174 219 233 135
114 30 134 93 179 48 98 139 223 194 90 19 205 198 173 138 12 113 46 217 14 99 24 215 114 230 15 156 168 242 124 171 245 83 118 246 213 61 251 153
211 45 187 5 231 244 217 198 146 160 140 112 184 222 2 250 13 98 137 201 88 224 10 233 11 87 28 126 15 3 252 38 17 245 236 194 85 118 191 80
162 134 196 179 221 2 13 226 141 230 246 26 132 118 45 245 186 8 107 102 16 33 56 2 47 160 27 221 70 76 230 98 77 14 226 231 17 175 248 160
41 149 144 225 246 90 100 93 222 231 192 62 7 64 163 74 173 240 123 121 114 131 205 87 124 140 138 11 47 43 131 217 185 144 129 75 252 5 129 248
6 78 6 56 199 132 115 124 111 84 19 115 72 227 38 42 35 90 177 175 203 110 91 160 6 35 77 2 12 139 175 242 196 228 193 239 3 158 75 62
252 1 66 186 204 108 212 26 185 18 94 255 210 207 91 125 108 143 214 110 197 30 207 238 3 77 191 220 196 147 28 23 221 40 169 244 155 23 201 162
15 110 114 151 16 60 29 131 163 94 1 184 69 29 11 7 65 29 13 65 8 47 246 180 27 33 178 93 235 219 64 105 39 93 95 250 138 37 217 53
189 69 120 231 195 255 202 244 159 44 143 69 19 116 8 11 84 47 70 169 98 177 251 231 167 2 171 15 79 102 200 99 105 117 32 81 246 15 250 73
171 201 82 232 128 224 11 226 105 191 13 93 106 79 62 144 216 138 241 156 118 130 84 186 227 67 55 214 162 51 135 111 86 181 42 21 197 207 40 56
65 49 142 172 3 91 67 41 234 55 110 180 217 51 42 113 11 144 215 139 20 250 255 60 13 226 102 16 152 126 44 196 96 17 172 96 156 111 60 135
192 233 181 104 157 214 58 116 30 142 17 219 237 245 190 212 147 65 155 146 189 70 7 156 23 225 176 247 129 97 204 175 170 214 91 224 23 141 253 45
99 86 210 225 144 253 128 122 153 222 172 159 184 244 24 170 189 131 194 203 125 214 149 62 251 113 65 91 118 190 104 233 234 62 14 43 10 145 5 72
