13 238 176 21 221 5 108 109 80 17 48 128 217 113 175 209 107 251 191 209 183 110 168 33 185 34 6 35 122 39 146 195 113 227 174 192 238 11 210 231 174 220 131 197 212 252 11 133 56 211
91 47 107 197 127 16 25 15 151 30 88 195 213 71 188 189 160 144 89 18 69 131 116 147 33 158 14 5 202 103 28 100 131 64 117 51 160 162 255 81 84 230 91 205 212 244 90 46 184 27
132 201 194 148 164 7 230 238 74 201 58 116 67 235 29 167 181 117 234 174 18 241 156 216 243 224 3 242 218 34 70 244 21 213 110 167 138 80 23 142 96 91 101 104 100 58 158 110 218 8
245 64 168 142 232 144 222 26 89 162 114 13 188 13 89 225 217 93 167 9 106 186 231 240 162 251 20 245 217 134 213 48 133 215 4 72 45 147 212 245 60 252 195 112 105 41 23 148 229 55
96 34 29 97 60 140 124 238 85 91 175 23 144 19 239 211 70 192 187 22 41 200 2 23 121 164 139 21 218 237 174 228 45 248 39 85 50 227 3 227 146 42 66 17 204 111 92 134 233 190
200 57 108 27 161 156 39 18 161 83 157 41 35 32 53 67 98 106 114 221 209 59 40 54 31 2 126 77 6 159 131 115 96 168 254 134 214 93 132 56 72 125 77 101 232 62 79 88 171 204
6 96 59 230 56 134 135 201 166 241 76 39 192 52 59 37 137 34 136 157 39 215 182 167 51 164 110 157 111 24 107 109 22 149 183 172 164 150 33 61 112 215 201 184 203 251 10 175 122 145
26 64 227 213 183 157 35 67 105 186 5 3 114 61 152 154 19 204 203 5 197 233 169 56 44 172 149 205 16 140 97 235 212 108 170 232 127 116 179 73 39 51 115 136 192 218 53 134 215 23
42 3 62 13 187 222 132 73 57 74 234 221 170 100 86 8 79 86 147 69 126 185 230 21 48 225 246 168 72 148 15 110 181 50 251 215 189 205 3 16 213 251 13 168 237 140 158 213 155 158
121 96 180 61 124 6 249 76 47 13 145 188 157 107 130 56 167 102 243 154 101 10 108 157 115 168 252 187 8 14 255 48 162 24 175 63 49 33 39 79 151 20 160 39 122 76 61 224 0 198
69 196 231 45 158 127 108 142 242 233 176 41 19 245 98 77 27 64 196 180 184 193 218 102 149 249 43 35 191 77 175 4 45 242 105 229 241 165 145 7 183 177 250 250 68 227 212 182 29 72
243 130 104 241 54 15 203 37 226 21 186 249 130 194 111 48 167 50 63 195 249 180 39 229 61 212 99 108 0 94 233 21 254 207 44 167 6 244 105 73 168 92 201 136 197 116 241 115 171 230
204 232 110 6 48 93 173 217 44 200 119 214 182 231 40 75 74 202 138 156 200 153 24 71 144 99 35 134 42 179 61 134 113 61 231 7 197 226 222 79 97 208 225 4 79 107 12 192 22 255
187 98 222 161 208 161 6 76 190 113 20 107 94 216 50 85 137 147 234 218 162 35 225 57 211 185 234 222 72 20 1 239 104 22 11 224 89 148 223 224 224 31 72 122 44 146 61 166 218 185
79 237 88 238 127 57 26 182 28 198 134 22 10 24 185 37 45 76 106 175 244 81 233 201 129 99 198 223 109 149 184 67 19 43 31 229 107 64 135 222 156 6 119 54 157 56 56 188 104 246
186 158 249 40 164 232 200 173 233 134 163 146 147 140 126 219 174 93 38 47 156 27 233 174 130 53 105 119 171 177 110 23 191 254 33 251 196 150 92 218 200 146 23 250 59 36 115 153 54 238
7 202 93 97 43 108 189 113 107 194 69 253 174 131 18 147 245 14 19 118 1 141 219 210 208 179 71 4 18 118 57 227 194 230 28 82 18 239 190 218 221 247 35 120 20 10 117 86 178 117
64 234 197 110 24 41 33 241 145 50 149 192 154 117 213 85 132 209 38 54 240 179 14 213 54 36 203 94 55 125 208 90 15 15 247 49 165 79 168 162 187 27 32 249 240 215 140 197 44 2
193 134 157 183 163 194 113 218 72 95 208 215 253 203 237 47 243 38 172 43 1 211 183 65 246 121 75 110 191 171 87 82 160 140 18 207 56 93 26 59 250 209 93 45 247 237 198 122 144 16
134 20 186 32 214 156 203 25 53 177 172 220 16 9 105 138 191 97 14 161 119 71 40 25 203 57 157 50 176 126 176 61 201 212 143 82 172 144 233 68 164 85 250 102 38 101 89 20 120 62
200 198 43 20 52 179 190 71 47 191 13 13 238 174 13 166 79 126 206 213 75 70 237 51 144 163 244 21 90 88 13 98 198 204 190 114 87 124 61 57 73 221 118 58 58 10 206 130 89 173
208 196 94 193 98 62 78 204 88 75 6 186 22 106 103 214 43 131 9 235 34 114 174 241 182 194 53 196 31 73 125 124 92 22 35 236 36 241 118 86 90 190 133 20 168 196 126 6 78 196
50 166 79 150 27 55 245 56 163 248 178 68 13 98 29 9 223 185 59 100 107 214 181 63 12 227 241 145 194 77 46 94 128 104 45 78 90 185 250 100 11 163 7 196 241 148 159 150 245 120
13 115 57 53 184 55 94 22 17 102 186 240 14 241 99 122 161 27 198 182 21 206 167 192 102 237 146 118 33 233 147 128 154 70 4 182 38 219 109 232 139 7 65 217 249 36 246 49 60 164
129 146 90 97 24 229 142 25 122 14 120 231 30 101 89 39 219 49 48 41 19 156 0 204 120 108 187 212 135 195 204 36 149 218 254 9 200 137 28 31 38 252 174 134 71 246 5 213 225 37
246 36 152 3 73 46 244 181 162 103 211 180 130 86 147 191 176 203 4 67 141 227 166 142 53 57 117 233 204 135 56 94 194 228 17 90 208 66 112 85 217 186 216 186 46 174 184 209 245 4
225 183 74 23 91 63 45 20 126 186 253 150 87 68 200 227 68 252 35 88 40 85 247 244 38 67 221 197 208 62 38 133 94 77 159 114 132 80 193 63 18 234 60 82 157 18 199 89 216 126
43 196 67 253 99 149 154 219 197 27 198 46 200 228 98 66 32 104 18 43 45 248 228 247 93 216 196 194 100 122 233 142 215 169 210 79 191 101 105 166 212 136 215 209 178 49 71 169 99 92
42 106 80 28 230 66 78 67 21 80 124 91 7 45 168 153 20 234 195 70 149 117 92 188 174 141 208 249 196 174 179 228 163 248 214 153 218 189 54 15 28 47 27 93 235 190 103 211 48 68
196 203 211 222 6 28 182 11 235 239 161 249 133 125 3 246 250 32 184 217 29 48 153 251 84 231 238 144 177 35 120 217 61 222 230 30 108 62 100 135 122 51 14 6 182 30 186 166 198 156
240 71 75 230 222 117 203 253 150 157 2 32 185 215 66 195 143 125 71 47 31 67 203 123 171 90 196 38 140 47 242 49 107 139 68 15 123 160 94 36 150 158 192 12 232 246 78 248 224 235
180 157 159 31 186 59 150 234 238 175 16 45 9 234 224 109 11 205 90 78 65 103 10 159 188 160 214 233 219 118 43 37 101 153 240 221 7 136 6 111 14 117 18 157 130 194 173 235 44 167
162 244 93 164 1 107 48 38 201 107 196 135 99 86 211 136 12 107 191 173 79 49 200 248 243 254 193 197 133 236 183 9 111 66 220 133 184 23 222 19 48 66 193 88 77 200 229 248 51 122
200 191 89 152 70 173 87 58 237 217 121 50 189 139 194 60 207 45 139 26 221 57 60 72 86 79 31 153 106 235 28 157 183 75 132 49 181 126 165 107 252 183 209 97 132 34 72 13 108 20
229 22 32 60 210 236 187 178 250 113 31 108 127 122 32 117 122 152 192 83 9 157 237 124 207 148 195 206 21 170 119 205 53 59 113 103 8 68 240 158 208 99 145 58 52 155 171 21 146 56
14 167 141 179 60 89 150 137 146 119 36 120 96 231 176 82 190 20 245 172 197 86 33 137 92 192 59 112 41 31 71 230 44 214 146 180 224 213 235 244 44 90 206 189 203 93 86 133 23 119
237 176 126 146 146 66 200 115 88 43 133 25 82 195 63 254 103 132 109 200 37 119 145 200 34 28 125 198 98 220 6 109 56 70 242 237 59 107 241 207 60 120 34 141 233 220 140 192 255 61
92 247 232 158 177 48 125 219 53 220 203 71 223 53 236 207 187 87 40 252 154 20 80 12 41 178 134 10 14 200 108 20 151 222 23 252 56 197 22 27 206 145 96 59 123 178 98 29 36 140
192 177 29 209 241 69 84 219 34 253 235 73 12 157 182 94 218 231 37 192 89 92 250 80 101 244 18 6 76 67 208 129 150 6 50 30 16 134 70 133 145 18 59 210 13 191 39 187 66 167
58 72 100 60 231 208 230 164 29 85 192 248 39 199 227 147 125 79 250 235 149 170 225 247 12 190 87 88 67 214 8 176 244 158 240 124 4 67 210 60 243 56 91 205 154 59 198 93 168 164
143 191 191 143 230 234 126 25 5 110 234 83 25 94 178 47 44 247 171 149 70 120 109 41 16 43 159 222 67 234 234 94 81 24 59 63 110 43 49 68 225 188 29 143 112 249 140 79 100 123
144 3 119 15 114 23 206 163 94 34 106 57 142 66 8 135 25 172 182 245 65 111 237 158 21 136 13 253 195 76 126 40 167 180 97 148 156 0 225 164 163 88 72 15 7 185 172 109 213 13
50 14 154 212 110 9 24 114 99 147 238 234 121 133 40 181 58 21 90 38 68 32 72 116 64 98 53 192 164 240 197 112 172 172 186 71 191 223 247 163 68 37 190 131 192 42 237 107 243 251
170 199 237 65 175 203 97 17 110 193 237 120 12 100 235 21 26 194 154 106 70 194 166 249 253 5 27 3 20 150 206 210 49 49 118 212 199 49 85 31 112 25 140 201 98 139 122 49 111 63
235 123 42 7 131 53 143 175 65 126 203 1 22 42 28 34 213 20 102 1 207 130 129 75 130 208 171 104 110 210 111 135 81 129 199 228 236 158 243 80 143 12 81 254 190 79 80 44 93 149
24 214 248 52 89 3 192 74 33 156 197 91 213 126 49 112 155 141 62 198 50 119 220 211 150 75 117 196 216 6 2 175 180 234 142 139 229 44 235 248 151 40 225 31 200 7 189 148 172 149
82 243 75 117 153 201 99 150 205 191 38 91 134 212 43 96 145 46 129 1 45 155 246 99 66 149 213 216 198 158 165 36 169 83 234 161 166 76 36 214 41 158 69 120 231 158 83 253 49 216
196 41 155 112 251 170 222 204 12 99 107 156 162 181 173 45 132 203 106 106 1 30 163 52 210 117 96 180 99 45 154 47 116 121 136 199 218 137 72 156 81 216 214 134 31 8 144 126 139 194
244 65 238 68 129 79 80 193 39 73 144 138 81 34 231 139 125 79 28 229 132 70 138 79 253 164 98 93 61 101 240 186 111 24 9 21 13 187 123 202 233 60 43 211 94 165 236 166 145 157
217 224 236 32 109 62 19 181 173 128 23 30 35 95 9 145 10 22 227 53 204 152 70 160 102 222 139 81 32 206 109 182 253 86 4 234 55 210 28 87 115 188 122 33 180 92 212 221 3 76
140 244 203 212 40 36 203 120 4 134 25 191 244 10 240 104 83 117 106 99 28 168 112 86 203 199 42 68 209 15 73 107 41 224 0 125 91 229 107 119 29 227 51 130 120 204 9 216 160 182
240 252 208 140 159 75 99 67 155 142 173 196 182 88 167 49 28 105 65 18 193 204 36 254 137 194 99 201 34 116 81 84 154 7 73 77 146 144 236 25 57 241 50 49 78 139 212 110 226 50
126 40 61 244 182 48 30 103 207 122 67 80 56 147 77 3 255 130 66 65 97 197 127 240 9 135 36 40 7 125 114 95 80 74 189 127 169 194 224 188 84 71 79 85 206 245 190 211 99 168
11 230 36 184 74 0 56 43 160 252 203 119 90 209 61 115 250 214 118 102 34 123 138 113 93 63 71 151 208 159 48 195 94 121 142 80 97 249 255 158 173 76 219 234 159 248 91 153 46 173
184 21 202 158 45 202 64 251 68 75 8 162 98 30 235 24 179 125 9 9 167 149 0 44 64 145 235 239 57 17 213 146 110 0 46 102 1 215 228 17 25 225 48 205 141 97 155 45 225 155
61 103 76 12 244 36 11 133 128 166 144 119 8 197 3 35 109 75 196 196 185 18 221 164 87 231 33 66 115 231 55 193 33 74 165 97 94 216 160 27 232 127 39 95 57 12 122 172 91 69
85 229 235 147 83 208 212 68 1 9 98 211 180 111 18 76 130 32 74 248 226 107 205 188 99 24 68 199 3 102 74 70 207 10 222 164 8 19 52 217 31 165 235 204 6 19 103 109 94 144
102 175 251 216 74 184 190 24 180 58 182 145 104 181 42 215 45 149 123 61 24 239 54 155 168 16 124 210 49 28 92 56 177 114 169 222 61 9 250 138 221 89 156 79 65 191 77 49 27 112
18 4 56 249 63 105 254 139 213 92 248 160 211 180 190 42 136 204 239 17 141 224 153 62 162 39 140 169 47 100 47 14 56 151 255 98 185 35 131 100 201 80 76 228 84 104 212 130 50 210
25 164 188 153 158 233 129 106 11 95 240 194 12 148 221 109 89 216 42 162 128 182 213 24 208 151 142 161 10 3 216 119 35 156 236 132 34 176 79 228 215 122 18 50 120 17 48 228 97 155
166 175 87 137 78 163 209 199 128 211 57 92 9 37 72 219 32 169 62 93 79 121 58 163 122 35 125 187 194 19 158 141 92 46 127 58 170 63 96 65 134 170 183 138 63 103 29 252 205 137
202 227 251 170 109 49 46 187 147 224 105 139 82 194 235 175 150 68 156 18 79 121 172 39 91 53 209 207 183 149 187 216 205 198 37 52 20 229 115 151 52 247 39 156 37 19 163 94 130 194
180 189 175 167 209 163 115 174 248 98 92 211 225 25 19 23 66 11 91 199 52 35 19 50 204 92 61 91 157 78 142 167 191 147 249 196 50 206 82 207 107 210 0 199 156 94 131 215 14 70
26 158 114 94 158 251 228 234 32 226 119 30 192 255 241 49 233 197 127 152 131 245 226 199 115 27 95 190 43 227 31 201 88 193 208 83 227 171 172 188 214 23 25 82 86 110 213 251 38 84
181 147 126 71 62 203 179 55 116 76 12 59 72 121 148 207 28 29 238 69 246 97 218 227 66 66 86 156 80 30 54 82 41 134 148 80 8 78 243 157 163 120 7 168 178 124 136 159 194 232
17 104 95 152 105 254 217 51 156 236 17 85 88 20 28 115 123 201 102 148 132 152 24 55 25 233 45 240 113 55 119 86 129 208 78 24 9 190 60 243 31 20 236 139 207 64 0 201 229 159
95 150 122 147 244 72 241 19 220 69 115 17 6 195 158 229 24 45 130 219 127 229 62 114 169 211 144 217 159 34 10 5 235 201 204 38 10 156 20 169 218 190 108 62 50 86 70 101 132 26
169 156 23 37 216 53 155 222 113 91 27 0 1 228 189 154 84 99 85 202 225 40 69 97 191 95 199 223 62 174 255 122 208 216 85 52 55 249 32 209 10 81 242 90 115 178 127 198 26 92
31 197 106 106 140 74 139 202 222 142 105 41 176 68 1 86 41 166 210 150 184 149 174 248 135 227 144 66 230 234 144 230 36 24 178 108 219 233 16 71 43 83 136 155 18 132 202 127 134 153
179 102 18 47 82 133 52 134 128 97 166 220 37 241 142 53 213 105 85 44 204 231 76 84 49 138 178 21 245 217 156 202 207 205 24 187 25 174 65 24 227 250 79 109 245 244 224 199 84 136
41 179 135 98 45 148 89 82 186 148 8 211 188 189 194 197 254 130 227 238 168 242 115 215 3 182 222 196 17 224 107 102 52 157 222 242 69 188 23 31 20 197 188 77 86 132 15 169 160 42
203 151 4 192 151 56 223 121 123 151 155 179 125 56 234 134 92 168 191 97 63 123 112 2 129 89 185 153 69 144 116 22 230 66 170 212 50 95 80 193 31 149 76 75 166 71 47 66 206 93
78 206 183 144 93 202 0 25 92 185 153 126 88 85 237 99 145 230 188 158 106 178 156 117 91 16 223 187 39 101 250 140 55 158 203 232 140 131 52 52 61 10 71 90 47 75 61 111 61 69
166 178 153 206 101 230 133 237 172 207 192 38 116 4 22 166 52 109 109 123 251 98 215 32 100 103 227 144 64 121 65 72 55 245 219 85 96 225 176 2 155 29 17 83 73 47 98 236 111 67
170 62 22 213 148 104 139 187 134 229 254 133 115 230 1 205 91 93 229 220 198 71 173 151 129 111 155 17 46 230 145 80 27 244 94 142 70 137 84 202 220 160 238 57 17 3 44 143 107 149
5 102 156 44 205 231 19 172 206 155 68 112 36 162 198 201 184 197 231 249 43 213 128 1 43 26 212 22 77 167 5 253 194 211 242 203 66 7 29 111 201 87 149 46 225 87 180 115 8 45
64 106 33 18 242 131 219 82 160 72 171 189 188 211 98 111 20 29 190 158 54 207 59 179 247 41 185 174 33 38 255 68 122 138 68 30 235 37 231 221 87 49 225 106 92 87 61 37 44 56
134 235 200 199 234 163 4 78 115 185 79 151 209 12 206 238 210 133 154 100 77 135 138 234 177 178 238 104 148 160 102 61 87 22 45 105 160 166 242 59 200 31 175 11 145 49 72 187 187 248
105 167 117 14 169 194 77 230 181 37 170 202 234 82 23 253 109 106 87 240 219 118 130 65 111 219 224 43 92 246 176 7 133 39 78 1 206 68 186 218 253 70 61 224 76 236 203 98 238 1
235 163 214 253 59 91 136 176 68 40 31 84 201 163 61 57 61 214 225 230 226 44 217 149 199 135 144 174 127 201 0 110 54 229 96 47 173 5 56 107 23 114 63 221 163 64 235 179 18 157
20 1 240 217 92 58 88 2 174 223 213 129 58 101 100 43 138 112 118 122 184 33 210 54 236 78 0 138 222 195 241 126 114 155 73 17 123 112 116 87 182 107 11 130 158 84 29 119 13 180
167 210 175 50 83 171 4 174 250 61 7 151 153 126 230 251 242 132 108 232 214 128 252 19 214 150 119 104 110 175 42 137 245 2 158 52 44 135 92 98 82 73 10 145 79 119 90 78 187 93
146 119 89 37 80 119 87 206 139 129 120 8 231 34 237 15 2 247 160 14 43 83 188 242 52 41 34 62 67 181 45 100 50 225 119 227 120 47 104 189 128 96 99 208 245 210 29 110 164 172
103 11 208 250 166 112 160 63 166 126 106 176 202 130 241 95 195 19 6 227 114 175 248 128 210 209 136 50 174 24 25 229 169 169 160 27 5 224 157 211 172 254 22 65 40 142 155 212 184 150
29 53 142 202 190 93 2 79 13 232 178 77 186 173 218 212 200 141 217 135 174 109 12 172 82 8 43 154 91 105 232 160 148 49 208 29 178 140 74 86 11 200 180 175 81 179 152 237 126 182
249 154 105 182 236 66 181 171 241 113 125 214 53 148 104 202 55 69 110 157 194 153 10 126 79 164 24 46 182 19 150 5 100 236 180 168 137 92 112 37 49 254 185 214 94 70 4 210 130 143
42 18 168 3 83 129 248 52 8 231 1 54 203 139 93 188 126 2 20 5 140 150 172 30 25 203 164 109 218 64 112 203 213 88 44 178 107 146 233 205 204 97 170 35 80 165 127 53 14 176
203 225 156 215 209 185 112 111 74 77 38 35 101 130 85 228 172 189 196 115 32 209 121 150 234 125 118 237 214 66 3 162 12 152 174 89 143 62 38 156 76 183 175 64 124 134 205 107 95 176
146 114 185 79 30 212 111 17 158 124 168 245 186 206 139 122 218 253 225 27 250 101 12 197 190 106 198 243 115 237 252 127 59 172 10 70 170 25 69 215 96 26 182 50 27 74 103 90 240 111
238 86 142 137 170 49 184 18 99 195 175 84 221 213 81 159 210 16 48 123 28 148 252 27 198 14 171 82 193 188 176 149 206 228 235 66 250 41 131 137 49 129 237 151 189 251 214 56 69 64
26 107 202 162 198 112 130 243 189 243 67 107 192 192 223 38 161 12 41 234 95 26 202 120 175 13 190 119 83 135 44 46 66 198 128 9 33 144 135 2 19 171 134 157 56 240 245 42 183 183
73 79 73 162 153 193 43 83 179 49 172 66 58 47 145 58 25 33 74 254 95 226 232 184 228 36 2 239 91 35 177 216 231 67 89 238 162 248 26 117 80 123 181 141 193 152 55 216 154 245
222 237 11 11 237 109 98 182 18 214 122 83 19 146 237 111 137 135 188 109 72 152 195 176 110 41 36 162 57 116 49 197 142 218 26 241 99 45 104 63 66 148 90 24 32 30 128 170 5 168
108 212 25 48 205 132 213 253 226 21 29 98 29 106 57 1 114 193 81 227 206 178 139 84 221 73 147 24 77 245 170 243 178 81 103 91 146 9 189 54 182 121 152 124 192 74 45 87 128 127
98 174 254 167 159 254 252 213 104 71 117 79 186 50 245 152 139 109 39 44 66 10 11 167 213 45 51 78 240 2 8 48 255 149 4 150 205 9 125 143 173 117 248 23 39 133 79 153 143 63
121 249 253 159 85 53 141 95 41 250 141 209 129 88 237 0 58 239 193 49 64 33 125 85 80 108 138 27 195 204 68 102 206 214 222 10 208 129 46 8 81 29 106 181 164 172 81 192 71 156
55 51 44 175 110 83 215 156 243 226 5 49 81 99 23 57 23 161 24 155 79 111 253 144 201 67 195 151 129 197 64 222 52 218 255 28 11 227 53 165 80 151 177 183 170 188 24 12 24 150
110 96 151 204 20 37 87 70 237 53 193 90 150 192 43 191 100 205 172 74 210 148 56 42 9 33 196 73 115 227 237 1 249 211 186 170 35 184 114 110 139 12 15 47 110 32 216 217 1 192
212 141 227 115 204 124 20 151 178 235 188 255 68 196 217 105 129 62 231 154 31 71 7 127 93 1 64 168 47 92 87 155 105 39 212 160 27 183 163 158 207 215 43 177 79 168 69 102 9 151
221 163 104 17 75 226 182 114 78 255 217 73 203 161 87 89 252 173 66 189 180 46 169 187 160 92 93 148 120 204 72 164 45 98 246 122 245 97 121 62 5 53 68 221 73 18 0 35 148 90
