196 140 237 10 42 88 47 38 242 169 95 99 60 95 62 72 206 78 109 20 144 93 203 137 95 147 205 18 57 194 190 18 226 203 189 22 206 0 15 175 214 44 17 136 185
142 141 207 220 6 209 195 69 31 173 148 87 104 16 234 73 235 126 195 139 44 73 253 204 54 14 224 94 13 127 232 92 101 169 255 11 99 32 24 156 37 49 69 217 183
18 7 109 73 158 84 166 34 22 157 124 254 179 156 50 46 154 119 145 242 228 90 211 244 145 96 186 210 26 24 70 11 9 151 17 223 3 138 212 204 235 119 40 108 93
144 151 253 57 235 148 232 71 23 193 121 213 167 85 37 164 98 206 210 167 239 222 208 110 233 24 121 220 75 9 202 73 240 147 76 126 51 87 153 7 133 99 162 95 73
21 189 167 229 105 187 48 236 26 197 42 3 162 3 164 194 11 104 1 76 252 8 178 90 219 248 232 212 14 122 187 52 183 13 46 114 236 122 93 44 94 65 82 106 100
94 205 120 142 63 211 23 110 41 244 113 52 91 131 220 62 0 215 139 146 167 74 202 159 117 2 106 134 62 224 79 189 176 91 163 1 70 141 81 55 195 55 137 124 91
60 82 4 170 102 185 105 144 124 59 5 219 72 141 174 102 211 96 91 159 199 212 212 50 62 11 156 226 178 3 123 221 43 46 45 20 239 2 91 237 164 186 90 162 111
190 64 199 179 114 67 20 218 174 232 67 198 135 231 53 111 11 176 240 190 24 186 151 107 247 55 118 44 119 20 129 153 240 107 118 45 239 231 214 219 131 237 140 129 153
17 146 223 220 55 19 139 153 70 17 237 185 161 232 183 240 90 232 202 159 213 67 162 56 99 151 225 209 134 102 132 121 220 54 227 214 233 178 85 126 139 155 86 174 128
12 82 120 172 8 239 163 164 161 107 176 14 105 17 252 253 52 229 62 235 61 90 124 195 173 206 171 220 103 107 168 1 142 151 83 70 96 40 168 119 150 88 173 47 242
9 247 171 40 54 25 85 164 112 200 249 242 54 152 28 59 1 8 167 68 116 247 32 28 71 203 65 66 104 42 142 101 248 118 206 168 37 243 17 205 173 209 62 148 118
45 127 40 100 250 251 10 224 207 157 191 114 146 186 122 225 66 13 144 17 143 8 15 164 169 112 19 138 200 96 114 215 202 53 112 40 232 128 54 201 242 163 231 158 47
188 120 12 179 172 88 39 194 0 62 95 63 149 113 18 9 151 195 142 62 182 13 27 223 52 151 249 138 105 119 172 8 43 89 86 26 85 114 250 34 2 225 43 44 160
192 145 225 167 140 39 5 59 139 33 103 1 53 214 178 59 188 243 214 91 187 175 168 55 35 15 145 162 110 161 217 19 53 191 53 116 45 16 39 126 112 48 68 141 200
164 121 51 238 237 238 202 13 26 117 106 54 92 74 159 6 246 205 113 114 245 153 59 98 158 22 156 247 126 134 27 3 203 131 224 52 26 137 179 250 233 172 112 221 178
53 194 51 215 143 36 124 167 92 75 226 213 151 216 214 207 4 57 26 193 151 111 254 218 190 154 27 13 180 187 183 32 174 181 232 243 199 147 244 142 17 79 233 216 177
26 6 86 102 180 130 209 44 247 28 197 212 108 55 79 85 131 81 215 151 127 84 156 114 69 154 53 153 237 106 37 45 127 160 186 158 201 233 217 131 129 117 6 232 112
157 137 17 123 101 215 210 122 200 153 158 171 76 149 186 216 218 156 184 163 206 195 255 108 230 136 179 164 55 83 115 181 248 211 71 86 9 14 29 142 69 191 48 63 33
50 152 167 189 100 136 139 210 237 144 246 187 193 197 129 199 77 231 25 14 155 181 174 84 84 112 50 178 254 187 203 157 188 64 21 223 219 220 214 21 121 115 247 100 250
213 12 65 226 120 101 138 134 157 223 22 81 3 92 19 173 37 242 74 254 89 144 112 208 67 87 130 87 155 178 126 118 214 17 27 59 110 161 122 196 159 71 3 10 1
200 122 142 241 171 224 236 225 213 57 198 141 53 219 221 116 189 251 29 131 103 120 106 98 5 119 23 122 160 43 245 161 124 79 166 115 89 237 233 138 253 178 89 165 216
178 123 241 77 40 0 76 33 41 136 159 165 136 218 214 107 137 227 219 81 57 126 193 67 142 164 222 53 246 211 222 195 104 165 103 132 177 10 148 210 76 14 6 116 108
218 15 189 58 91 254 243 113 105 135 103 160 165 114 158 3 20 65 142 212 56 121 161 71 179 203 233 161 12 144 0 236 21 237 248 117 42 94 9 77 133 56 175 71 186
126 246 183 145 166 152 134 156 244 65 224 238 82 190 181 141 179 151 5 80 78 62 171 2 141 138 9 151 164 6 33 240 184 212 100 142 132 12 38 89 94 238 121 146 162
45 155 61 68 221 116 194 18 252 14 104 76 104 205 226 19 123 28 145 119 226 148 141 143 13 84 216 121 88 192 15 29 27 210 232 164 138 38 27 212 139 149 20 96 10
168 126 49 128 187 35 166 145 255 162 194 240 21 138 240 160 108 193 100 124 72 108 148 85 201 226 112 231 177 204 58 114 117 84 103 63 213 180 127 130 235 149 196 109 53
18 115 20 91 8 40 208 155 182 228 138 160 59 136 81 130 9 159 158 123 153 130 51 180 231 211 255 246 210 178 88 218 130 164 217 47 86 72 175 154 15 49 75 67 241
202 138 94 22 142 65 232 206 10 152 37 10 136 197 67 101 40 245 28 70 207 184 231 27 195 7 85 122 205 190 169 215 17 198 162 250 86 133 165 186 105 67 206 234 116
181 122 22 250 182 13 2 212 185 131 179 108 47 56 45 151 25 155 74 191 163 127 100 159 250 151 4 194 84 154 31 71 75 12 133 235 116 196 85 154 123 64 160 135 4
151 211 54 221 211 39 118 117 100 250 148 68 140 132 214 166 88 228 152 124 51 73 216 102 66 119 192 239 29 170 127 85 1 249 6 161 45 229 171 66 82 136 29 139 196
229 4 176 46 105 127 254 84 104 68 137 246 59 83 168 213 26 200 9 148 18 79 254 177 86 209 252 200 198 246 206 145 48 58 59 251 18 116 131 157 161 49 90 202 187
57 98 167 44 173 168 152 8 207 197 137 69 196 134 208 125 21 189 160 135 229 103 108 57 76 134 236 80 201 160 195 48 66 158 66 211 36 157 123 232 38 173 178 188 125
51 251 47 97 33 224 242 233 251 46 51 44 30 242 153 194 56 224 185 213 140 208 195 59 110 138 168 201 206 41 46 233 5 91 132 108 234 170 64 92 101 1 75 239 193
189 152 228 38 19 223 247 237 158 26 235 36 162 11 25 240 212 50 215 199 175 48 53 31 170 150 145 33 251 46 2 150 46 233 110 58 30 89 169 68 228 196 25 94 157
223 41 99 105 242 57 39 9 241 132 84 29 78 177 107 57 238 247 212 198 59 68 25 155 255 245 69 180 94 128 196 97 147 207 159 224 155 221 55 65 157 4 117 241 153
163 31 140 118 219 233 167 8 8 229 66 148 234 105 208 8 194 254 155 239 88 3 217 118 227 56 82 53 43 113 195 235 237 145 133 64 56 187 34 242 116 187 90 14 82
131 207 220 222 56 35 214 88 115 59 112 171 250 139 45 177 160 26 215 18 9 129 230 102 123 226 51 148 241 77 46 129 186 152 9 85 4 192 197 240 204 162 161 138 250
214 172 236 114 21 46 252 235 157 118 54 218 79 122 122 147 250 132 197 166 237 126 231 46 230 146 36 254 227 182 24 16 184 251 152 184 73 68 160 6 180 159 84 63 50
17 100 174 98 94 230 199 195 29 56 209 32 160 7 9 70 103 53 51 56 2 135 94 32 149 124 208 249 171 35 186 253 53 186 169 109 254 68 9 235 54 101 97 235 155
224 72 232 197 63 1 46 9 59 21 5 78 119 207 164 103 174 86 122 60 134 13 124 113 104 104 69 110 113 101 112 46 242 97 170 27 118 60 174 170 140 170 66 61 36
209 6 39 96 133 231 228 18 176 130 134 229 70 236 240 102 189 180 174 205 8 22 201 40 134 4 7 212 137 141 4 125 247 30 112 122 177 31 154 230 11 254 197 231 33
69 207 127 47 201 71 61 14 238 111 186 230 6 64 130 208 223 7 83 102 42 185 168 191 169 190 245 85 163 242 156 228 108 8 220 46 121 26 249 187 122 57 244 188 238
20 134 4 161 179 207 181 39 119 73 224 130 73 157 211 90 90 194 192 72 151 10 241 102 163 163 6 111 23 149 252 103 232 99 26 245 96 40 123 60 217 66 11 137 204
197 78 188 0 34 79 23 216 29 57 159 162 177 106 127 176 224 157 220 202 135 105 138 21 81 100 68 134 134 190 155 212 43 75 53 182 188 211 182 77 181 46 136 98 228
18 226 101 158 34 126 63 24 181 23 75 67 63 55 20 11 194 239 79 160 83 82 77 65 88 76 197 225 73 151 79 223 42 213 0 32 162 21 35 138 46 146 89 168 123
41 172 193 189 26 59 17 106 42 53 183 243 204 2 34 206 215 211 183 73 88 224 89 185 25 18 15 46 20 63 113 100 0 191 129 27 22 239 93 218 190 116 32 199 104
249 160 33 231 138 182 249 108 77 135 135 123 146 123 12 71 233 35 129 167 238 79 72 91 129 130 239 8 217 64 181 230 27 23 63 119 147 18 128 24 37 202 176 52 23
199 124 247 183 83 37 179 254 78 68 254 125 48 107 79 38 102 156 115 131 75 164 185 22 56 167 154 167 101 24 25 202 53 61 137 174 138 255 165 33 86 58 25 41 82
191 45 125 30 186 105 26 4 4 250 142 96 106 123 201 158 153 220 18 215 137 150 214 0 108 175 183 24 18 55 22 80 124 93 138 184 129 12 128 63 59 44 156 208 50
218 52 97 222 148 6 210 241 192 130 150 71 240 204 99 10 115 169 156 191 108 205 102 49 200 92 107 57 136 254 67 244 25 173 212 3 41 144 161 203 54 160 245 40 164
225 7 182 55 151 132 36 196 115 154 243 7 19 121 119 150 142 216 71 38 105 239 188 31 61 232 151 34 0 87 175 173 232 245 45 38 184 18 213 201 31 189 97 151 117
5 184 216 190 27 141 123 139 50 29 249 23 138 174 0 202 244 2 159 85 2 61 51 162 22 206 80 173 170 237 3 189 15 84 184 55 84 82 247 78 107 229 32 132 230
202 40 58 111 172 250 241 149 218 240 25 60 240 56 91 46 43 236 149 144 40 176 245 174 146 44 121 95 37 33 188 207 17 25 50 97 228 18 75 85 98 80 128 196 193
66 238 78 215 44 240 89 181 5 197 15 55 38 79 48 31 138 104 101 107 237 222 156 252 32 180 100 8 43 63 67 181 36 169 192 19 250 245 86 61 245 16 73 137 162
243 105 226 120 19 3 112 161 40 196 216 13 202 61 172 24 121 128 27 112 129 124 54 171 198 219 208 151 0 29 53 202 67 178 74 41 98 74 37 145 134 194 215 185 111
182 6 26 59 5 41 212 197 110 45 136 142 107 158 88 17 197 145 22 206 212 89 85 186 1 50 94 223 153 142 73 60 233 56 188 173 25 205 160 235 16 130 25 139 191
135 127 249 80 161 99 160 125 178 211 122 94 11 242 51 249 203 78 84 151 171 138 229 2 92 229 8 3 24 198 115 119 132 188 184 76 67 235 241 144 34 25 67 198 132
41 61 121 186 160 27 189 10 59 9 176 81 209 88 14 211 233 250 191 199 131 60 78 53 2 52 228 221 38 125 12 221 223 173 198 49 131 68 87 218 67 31 67 255 182
3 69 41 150 165 109 53 19 126 222 51 248 45 20 125 170 167 1 97 113 226 91 229 140 101 237 149 207 85 156 197 61 37 109 60 169 75 167 69 137 142 230 70 101 10
137 85 245 249 211 97 100 126 18 107 24 239 106 164 115 146 250 235 124 1 215 158 110 43 20 28 50 205 212 77 83 230 230 173 230 226 166 106 37 128 105 241 100 87 72
101 194 30 179 81 170 230 100 59 77 82 92 24 198 187 68 169 153 105 190 106 203 116 146 178 204 20 254 147 231 124 57 212 204 81 151 151 103 14 81 169 131 127 138 250
11 108 9 223 54 74 199 181 78 197 126 116 246 204 118 132 177 23 126 71 164 51 145 163 219 255 162 0 38 161 64 217 112 0 202 98 182 249 78 0 6 38 10 82 214
77 108 104 169 194 101 60 185 138 225 137 185 75 104 71 103 193 255 148 162 197 211 49 209 119 181 195 170 115 77 26 10 93 219 157 5 28 183 57 182 216 228 229 7 51
184 87 174 118 92 57 33 208 59 23 95 4 201 187 193 177 1 69 132 190 24 222 227 77 184 235 108 207 151 99 34 100 54 148 201 104 182 149 0 122 117 44 247 155 247
35 185 122 165 23 29 155 32 190 233 63 158 243 4 35 218 18 102 114 114 176 247 7 51 54 158 101 61 37 162 120 32 113 28 67 240 237 203 50 122 75 149 27 216 206
247 119 141 237 103 104 205 53 1 103 19 225 146 184 122 125 192 188 82 224 233 37 156 68 171 156 57 160 110 100 13 103 55 219 88 92 238 34 83 5 65 168 221 50 156
246 235 207 185 182 168 23 2 71 237 121 255 170 49 197 33 232 241 154 214 155 85 26 30 164 244 248 114 106 46 151 169 208 45 1 188 119 73 47 191 145 233 103 168 196
68 170 245 212 50 77 39 198 211 223 95 201 216 144 234 213 183 73 94 89 44 91 4 159 192 76 88 141 47 27 65 189 99 178 131 164 164 224 205 25 224 84 6 171 145
244 71 2 50 247 191 128 222 131 83 216 105 115 169 186 165 70 62 164 171 69 101 162 84 207 136 176 115 26 243 166 187 84 137 163 89 175 89 208 45 161 163 200 6 167
204 194 107 101 44 28 84 104 39 144 100 136 192 217 242 29 113 233 252 44 169 186 140 106 225 207 222 198 5 8 254 184 120 95 59 123 170 230 31 64 111 199 2 188 229
202 254 163 213 67 9 108 162 233 87 144 96 105 246 141 154 62 180 162 181 85 87 130 59 170 88 172 147 109 169 149 20 206 82 65 101 6 50 155 143 211 238 126 29 200
3 49 198 71 220 199 19 135 117 189 160 196 45 104 164 36 20 200 91 78 3 158 254 31 207 119 97 126 240 21 168 255 235 58 89 112 72 161 82 158 49 77 237 73 118
59 186 122 17 5 122 35 43 38 231 107 16 160 155 253 198 68 150 161 58 154 130 214 152 195 246 218 215 5 34 221 71 53 24 202 194 6 62 244 155 169 97 195 200 186
121 238 3 254 35 22 42 159 50 71 226 247 172 137 237 86 132 174 151 23 35 27 134 25 19 251 159 223 179 196 209 16 234 237 153 203 114 253 209 229 124 140 180 54 69
92 28 159 146 146 144 134 71 116 218 61 143 30 214 182 18 209 241 179 188 91 37 190 44 73 81 77 140 228 13 143 149 138 231 141 218 155 217 119 125 157 55 126 158 85
134 97 254 227 40 55 175 58 178 154 222 3 13 153 116 133 149 232 41 176 173 101 251 239 248 160 102 207 176 6 147 237 153 217 77 102 227 89 201 170 159 177 185 163 160
113 165 166 202 193 33 133 152 70 230 139 147 138 95 128 102 195 208 130 21 152 50 125 67 68 217 178 131 227 43 101 12 112 37 105 147 30 209 153 39 74 240 232 128 249
135 194 30 127 76 194 163 4 186 73 42 171 31 169 218 231 76 82 97 88 249 135 227 11 96 175 249 151 135 252 171 127 115 249 204 236 18 140 120 133 158 253 116 172 149
112 215 145 133 241 137 160 196 252 235 157 250 39 180 84 64 217 63 43 11 186 79 44 215 47 47 238 7 79 91 35 99 110 217 5 138 182 209 105 108 236 66 80 147 116
11 55 184 241 35 38 102 192 189 111 32 210 199 16 12 157 55 21 120 117 70 155 112 214 73 63 251 120 163 62 162 125 124 210 227 153 58 18 102 23 62 133 36 192 112
217 236 136 40 34 219 31 101 158 103 3 190 142 251 180 230 170 122 68 82 186 210 34 232 25 64 234 161 147 6 24 135 176 137 76 254 117 126 197 37 87 166 5 102 27
187 201 2 84 129 20 116 194 168 222 144 151 226 40 152 112 13 225 242 170 34 205 101 223 221 226 49 6 107 151 134 240 37 157 96 156 2 33 183 65 121 216 63 123 188
128 128 131 75 5 168 211 116 33 58 184 117 254 129 94 46 54 5 133 125 158 199 189 13 34 160 16 173 11 232 146 16 43 178 119 209 48 29 246 175 56 104 90 65 253
215 235 249 130 131 5 198 194 3 246 81 96 97 216 62 171 218 14 103 245 231 244 216 194 179 93 132 232 122 88 31 171 219 42 198 116 128 180 237 88 109 23 207 141 149
143 253 159 2 147 164 220 15 149 92 111 241 58 231 192 125 26 117 229 149 42 18 227 193 159 182 142 44 156 102 4 5 85 237 49 134 207 44 222 113 189 107 17 100 218
21 140 145 176 183 189 126 218 8 4 26 168 117 1 94 77 158 8 201 190 100 132 70 88 29 37 15 30 145 32 102 166 132 186 188 17 43 204 38 36 237 245 169 17 15
145 61 121 91 41 63 160 55 83 135 165 3 85 215 42 24 141 88 101 50 8 116 246 103 28 135 43 60 153 171 74 245 99 240 22 138 13 166 95 243 153 65 108 159 158
151 172 122 81 219 121 189 237 20 19 106 4 183 253 86 12 209 205 118 80 1 147 97 67 94 48 122 194 63 30 201 120 47 127 29 37 252 199 241 4 189 155 100 220 163
92 162 241 111 151 233 107 149 51 13 67 236 88 128 214 32 195 95 237 175 81 65 51 191 224 202 40 63 159 13 52 191 227 227 97 191 175 158 178 11 100 245 85 171 53
97 139 204 248 125 190 242 209 198 89 96 166 235 42 217 101 217 41 30 35 191 21 99 207 54 180 185 153 204 3 249 61 73 87 22 3 216 115 240 179 59 140 40 43 151
